NER, the city of Tarragona, Spain, to which division does its northwest location belong	Batea,_Tarragona	nw
where is the birthplace of the city of Captain of The club of NER	UEFA_Euro_2012_squads	club	coach	currentclub
what time zone is in Northwest of NER	The_Senia	nw	subdivision_type
which house does the legislature of the source location of NER belong to?	Reuss_(river)	source1_location	legislature	house
which rank does the people, things and things with the same name as NER belong to?	USS_Abele_(AN-58)	ship_namesake	subdivision_ranks
which league does the operator of the stadium that NER takes place belong to?	2013-14_Barnet_FC_season	stadium	southeast
what is the timezong of the city in the south of NER?	Polynya	s	w	timezone_dst
what is NER Coach University	Russia_women's_national_volleyball_team	coach
who is the predecessor of the parent of NER?	Francis_Russell,_Marquess_of_Tavistock	parents	predecessor
where did the person named NER live?	Cori_(lunar_crater)	eponym
where is the birthplace of NER's ship name, un barku den fransia?	French_cruiser_Foch	ship_namesake	birth_place
what is the classification level of a person or thing with the same name as NER	HMS_Starling_(1829)	ship_namesake
what is the timezong of the city in the south of NER?	pine_trees	s	n	subdivision_type
what club does Captain of NER's Club	2009_FIFA_U-17_World_Cup_squads	name
who is the president of Inaugural speech of The title of NER	Betty_Ford	title	incumbent	order
which series the NER Related Things belongs to	sony_xperia_z3+	related	series
what is the occupation of NER Timeline	Themes_from_Calmi_Cuori_Appassionati	chronology	profession
which language is used in the author of NER?	Tyranny_(Julian_Casablancas+The_Voidz_album)	chronology
what is the name of the predecessor of the club that NER belongs to?	Football_at_the_1990_Asian_Games_-_Squads	club	before	name
what time zone uses Northwest of NER	El_Molar,_Priory	nw	subdivision_type
which type of subdivision does the west of the north of NER belong to?	Utah,_Utah	north	west	subdivision_type
what is the Standard Settlement of NER's Northwest Site	2014-15_Washington_State_Cougars_women's_basketball_team	home	northwest	settlement_type
what is the specialty of Election after NER	Cameroonian_election_election,_2002	after_election	title
where is the location in the northwest of the football match NER?	2013_AFC_Champions_League_Final	city	northwest
where is the constituency of the Western Start of NER	List_of_night_buses_in_London	via	constituency_westminster
what is spoken by the lyrics of the title of NER?	The_Beat_Goes_On_(Super_Junior_D&E_album)	title	lyrics
where did the eponym of NER study?	Arrhenius_(lunar_crater)	eponym	work_institution
which title does the country that is spoken NER belong to?	Uija_of_Baekje	
what language uses Lyrics from NER's title	The_Beat_Goes_On_(Super_Junior_D&E_album)	title	lyrics	language
what is the level of management at NER's vessel name	INS_Kavaratti	ship_namesake	country_admin_divisions
First Lady of the United States; Wife of the 37th President of the United States NER (1912-1993) where was the title of successor to Pat Nixon	Richard_C_Atkinson	data	affiliations
which city does the location of the birth place of NER belong to?	Trevor_Leota	birth_place	location	city
whose ancestor is the father of NER?	Prince_Regent	
who is the predecessor of Election after NER	Mongolian_legislative_election,_2008	after_election	namedata
what is the level of management at the southwest of The place of death of NER	Edmond_John_Fitzmaurice	death_place	southwest	subdivision_type
which place is called as the subdivision of the northwest of NER?	Gurb	nw
NER's election winner who's successor	First_Māori_elections	after_election	title
which musical instrument NER timeline used	Identity_(Zee_album)	chronology	instrument
where did the person, thing, and thing with the same name as NER die?	HMS_Bigbury_Bay_(K606)	ship_namesake	death_place
who is the manager of the operator of NER's venue?	2013-14_Zamalek_SC_season	stadium	operator	manager
who are NER's parents' successors?	Jawaharlal_Nehru	children	after
what is the club that the captain of the club that NER belongs to belongs to?	2015_FIFA_U-20_World_Cup_squads	club	coach	clubs
what is the management level to the southwest of NER's place of death	Thomas_Mardaga	death_place	southwest	subdivision_type
what dynasty belongs to a person or thing with the same name as the passenger ship NER on the Italian route?	MS_Giulio_Cesare	ship_namesake	house
when is the people, things and things with the same name as NER born?	USS_Susan_B_Anthony_(AP-72)	ship_namesake
what is the name of the administrative district of Eastern Site of NER	2016-17_Southern_Utah_Thunderbirds_men's_basketball_team	home	south	subdivision_name
which president does the NER's election winner serve?	Abkhazian_presidential_election,_2014	after_election	president
who is the most important team owner of the Finnish racing driver NER?	Heikki_Kovalainen	after	before
who is the successor of NER's election winner?	Italian_general_election,_1874	after_election	after
where is the graduating school of the lyricist of the title of NER?	The_Beat_Goes_On_(Super_Junior_D&E_album)	title	genre
A city in Emory County, Utah, United States, located in the southwest of NER, the location in the west, which time zone the location belongs to	Emery,_UT	southwest	north	timezone_dst
who is the starring role of the works that make NER known?	Khalid_Siddiqui	notable_works	extra
what is the subdivision rank of the people, things and things with the same name as NER?	HMS_Sparrow_(1828)	ship_namesake
NER what is the zoning of the location in the west of its location	2017_Lamar_Hunt_US_Open_Cup_qualifying	location	west	subdivision_type
NER, a Chinese politician (1913-2010) who is the current incumbent of the nominee for his title	Huang_Hua	title	incumbent	spouse
which timezone does the northwest of the home to NER belong to?	2014-15_Northern_Colorado_Bears_women's_basketball_team	home	northwest	timezone_dst
what are the affiliations of NER's alma mater	Wayne_Chabre	alma_mater	affiliations
where is the captain of the tenant of NER born?	Atletion	tenants	stadium	tenants
what is the management level of North East NER location	2011_in_Ecuadorian_football	location	capital	subdivision_type
which rank does the person and things that shares the same name with NER belong to?	SMS_Seeadler_(1888)	ship_namesake	image_caption
who takes the place of the descendant of the father of NER?	Ann_Widdecombe	
what is the subdivision rank of the people, things and things with the same name as NER?	USS_Skimmer_(AMCU-41)	ship_namesake	image_caption
what is the level of management at East of NER's location	2013-14_King's_Cup	location	n	subdivision_type
what is the name of the administrative division of the Northwest of the Southwest of NER	Laketown,_UT	southwest	north	subdivision_name
what is the name of the administrative division of The North West of NER Millionaires	National_Register_of_Historic_Places_listings_in_King_County,_Washington	city	northwest	subdivision_name
what is the job of the lyrics of the title of NER?	The_Beat_Goes_On_(Super_Junior_D&E_album)	title	genre
The location in the south of NER and the location in the east belong to which division	New_Harmony,_UT	south	east	subdivision_type
who will be the next NER Timeline dj quik, lord tariq and peter gunz?	The_Way_It's_Goin'_Down	chronology	after
what type of settlement is in the NER ship name	HMCS_Edmundston	ship_namesake	settlement_type
NER where is the successor of the previous generation	2011_AFC_Asian_Cup_qualification	stadium	before	after
what is the region of the county that NER belongs to?	Burgess_Hill	shire_county	region
where did the commander of NER die?	Canton_of_Aiguilles	chieftown
what is the type of person whose name is in the Wikimedia listing article NER	List_of_awards_and_nominations_received_by_Bunga_Citra_Lestari	name	genre
and NER what is the area to which people, things, things with the same name belong	ROKS_Cheonan	ship_namesake	subdivision_name
what team is the captain of the NER club location	Japan_national_football_team	club	coach	currentclub
what important positions Election has after NER	Labor_Party_(UK)_deputy_leadership_election,_2015	after_election	honorific_suffix
what is the subdivision type of the north of the city that NER lives in?	National_Register_of_Historic_Places_listings_in_Box_Elder_County,_Utah	city	north	subdivision_type
which type of subdivision does the northwest of NER spain, belong to?	The_Palm_of_Cervello	nw	subdivision_type
what is the job of the predecessor of the lyrics of NER?	Prudence_Liew_(album)	lyrics	before
where is the operator of the venue of NER?	2012-13_Greek_Football_Cup	stadium	tenants	ground
what is the currency of the event that starts the venue that NER is held?	2014_Davis_Cup_Americas_Zone_Group_I	venue	currency_unit
do You Know what Language Lyrics Of NER's Title Is Using	Ride_Me_(album)	title	lyrics
what condition is Alma mater from NER	Paul_Bailey_(politician)	alma_mater
NER where are its main towns located	Canton_of_Gagny	chieftown
who was the Election after NER before	French_legislative_election,_1893	after_election	title
who is the predecessor of Wallner's election winner?	South_African_general_election,_1977	after_election	predecessor
what is the area covered by the Events in NER	Archduchy_of_Austria	event	territory
where is the birthplace of the person or thing with the same name as NER?	Otto_Hahn_(ship)	ship_namesake	birth_place
what is the currency of the event that starts the location of NER?	1962_CONCACAF_Champions'_Cup	location	established_event	currency
who gave birth to the people, things and things with the same name as NER?	French_frigate_Hebe_(1782)	ship_namesake	children
what is the name of the Northwest administrative division of NER	El_Montmell	nw	subdivision_type
what is the occupation of the creator of NER	Stormy_Weather_(Lena_Horne_album)	chronology
what time zone uses NER South	pine_trees	s	n
where is the city of NER Station location	Lost@Sea	studio	subdivision_type
what the problem of The Winner of NER is	2014_Enugu_Government_House_attack	place	seat_type
what is the name of the ocean to the northeast of NER's county?	Alcobendas	postal_code_type
what is the other name that the alma mater of NER is known as?	Art_Peck	alma_mater
what is the subdivisionRanks of The name of the vessel of NER	USS_Searaven_(SS-196)	ship_namesake
who is the predecessor of NER's election winner?	Colombian_presidential_election,_1998	after_election	predecessor
what's wrong with The Father of NER	Princess_Pingyang_(Han_dynasty)	father	issue
what is the management level of NER ship name un barku den india?	INS_Mahé	ship_namesake	blank1_name_sec
NER Northwest location in which area is the southern location in?	Koosharem,_UT	north	southeast	subdivision_name
where is the artist who sings for NER from?	Languages_of_Papua_New_Guinea	extra	nation
which timezone does the northwest of NER belong to?	Batea,_Tarragona	nw
what time zone is used in South of NER lands of the ebro, tarragona province, spain?	El_Pinell_de_Brai	nw	timezone
which stadium hosts the NER Divisions	2009-10_in_Australian_soccer	division
where did NER play and get a job?	Hyon_Yong-chol	alongside	namedata
what is the title of NER's election winner	United_States_Senate_election_in_Kansas,_2014	after_election	title
NER, the former Boy Scouts Board of Utah, USA, what time zone does the location east of its location belong to	Utah_National_Parks_Council	location	east	timezone_dst
where is the alma mater of the people, things and things with the same name as NER lead ship of its class?	USS_Arleigh_Burke	ship_namesake	alma_mater
what is the subdivision rank of the person and things that shares the same name with NER (a barku)?	HNoMS_Myg	ship_namesake	subdivision_ranks
where is the birthplace of NER's ship name	RV_Neil_Armstrong_(AGOR-27)	ship_namesake	birth_place
what is the event of the cause of NER	First_cabinet_of_Louis_Napoleon	
what are the affiliations of NER's alma mater	Joanne_Grant	alma_mater	affiliations
what is the name of the administrative district of South East of NER Millionaires	National_Register_of_Historic_Places_listings_in_Utah_County,_Utah	city	west	subdivision_name
what are the important positions held by NER ship name	Warren_Hastings_(1802_EIC_ship)	ship_namesake	office
what is the management level of NER's ship's name	Brazilian_iron_clad_Tamandare	ship_namesake	subdivision_type
what is the surrounding city of the region of the nationality of NER	Suluova	subdivision_type
who is NER's father (mother)?	Francis_Russell,_Marquess_of_Tavistock	parents	monarch
what is the level of management at Northwest of NER	Vilada	nw
which dynasty is the one that is after election of NER born?	Town_of_New_Plymouth_by-election,_1865	after_election	place_of_birth
where is the birthplace of people, things and things with the same name as NER?	SS_Charles_Bulfinch	ship_namesake	title
what is the time zone of NER Northwest	Mieres,_Girona	nw	n
which label does the author of NER work for?	Stormy_Weather_(Lena_Horne_album)	chronology
what titles do descendants of NER have	Christopher,_Prince_of_Schleswig-Holstein	issue	title
which party does the legislature of the location of NER belong to?	Uzbekistan_national_football_team_non-international_results	location	legislature	party
The names of leaders of people, things and things with the same name as NER are	Russian_submarine_Severodvinsk_(K-329)	ship_namesake	leader_name
where is the birthplace of the person and things that shares the same name with NER?	RV_Neil_Armstrong_(AGOR-27)	ship_namesake	birth_place
who is the general of the person in charge of NER?	INS_Trata	controlledby	commander
what is the instrument that the author of NER plays?	Hoagy_Sings_Carmichael	chronology
what is the club where Captain of NER club works?	Japan_national_football_team	club	coach	currentclub
what is the classification level of a person or thing with the same name as NER	HMS_Jaseur_(1807)	ship_namesake	subdivision_ranks
what is the subdivisionRanks of The name of the vessel of NER	HMCS_Cormorant_(PCS_781)	ship_namesake	image_caption
what is the industry of NER's sponsor?	Louis_Schwitzer_Award	sponsor	industry
who is the Founder of the NER Dynasty Explained	Ladislaus_of_Naples	spouse
where the birthplace of NER's ship's name is?	French_ship_Somme_(A631)	ship_namesake	origin
who is the predecessor of NER's election winner?	California_gubernatorial_election,_1863	after_election	title
which place does the games of NER take place?	UEFA_Euro_2000_Final	event	stadium
what is the card description of the NER's ship name	French_ship_Polyphemus_(1815)	ship_namesake	subdivision_type
what is the language used in Cities affected by NER	2006_Yogyakarta_earthquake	countries_affected	subdivision_type
what is the administrative district of The main town of NER	Canton_of_Aubigny-en-Artois	chieftown
what is the name of the administrative district of The north of The stadium where the NER took place	1975_Rugby_League_World_Cup	stadium	north	subdivision_name
which award is the one that is after election of NER given?	United_States_presidential_election_in_Minnesota,_1968	after_election	awards
what is the common language of the person and things that shares the same name with NER?	French_destroyer_Tonkinois	ship_namesake
which type does the largest city of NER belong to?	Herb_Agocs	alma_mater	subdivision_type
what club Captain of NER's Club worked at?	2010_FIFA_World_Cup_squads	club	coach	currentclub
who does the job after the person and things that shares the same name with NER?	President_El_Hadj_Omar_Bongo_(ship,_1978)	ship_namesake	title
what is the title of the children of NER?	Joseph_Chamberlain	children	predecessor
what the NER Timeline team is	The_Way_It's_Goin'_Down	chronology	before
where are NER related events held?	Copa_America_Centennial_Final	event
what is the canton of the north of the location of NER?	Toulouse_FC	ground	location	south
who is the spouse of the person or thing with the same name as NER?	King_George_(1785_ship)	ship_namesake	house
what do the creators of NER do?	BEST_(After_School_album)	chronology
what is the management level of North East of NER World Day Venue	1991_NBA_Playoffs	place	southeast	subdivision_type
What's the latest show from NER's Notable Works	Hiro_Fujiwara	notable_works	studio
what is the management level of The North of The South of NER utah, united states?	Logan,_UT	north	southeast	subdivision_type
where was the birthplace of the person whose name was used to name the NER	Lippershey_(crater)	eponym
what is the subdivision type of the location province of NER?	Koksay	state/province	subdivision_type
who does the job after the parent of NER	Francis_Russell,_Marquess_of_Tavistock	parents	successor
A city and county seat in Millard County, Utah, United States a location in the north, and what time zone is used for a location in the north	Fillmore,_UT	southwest	east	north
what is the subdivision type of the south of the location of NER?	2014_Santos_FC_season	location	south	subdivision_type
what is the management level at the South West of NER World Day Venue	Wilmington_riot_of_1968	place	capital
who is the predecessor of The leader of NER	Cambodian_general_election,_2018	leader	predecessor
what the battle of NER's ship's name is	USS_Hannibal_(AG-1)	ship_namesake	battles
who is the successor of NER's election winner?	United_States_presidential_election_in_Minnesota,_1968	after_election	successor
what is the birthplace of The NER Coach	Medevce	subdivision_type
where is the main town of NER in a French state (as of March 2015)	Canton_of_Neuilly-Saint-Front	chieftown
who is the leader of the Life of NER location	2014-15_VfL_Wolfsburg_season	location	west
which field does the person and things that shares the same name with NER work in?	Akademik_Lomonosov	ship_namesake	workplaces
who was the Predecessor of L'avant de NER before?	Pierre_Pflimlin	before	predecessor	before
what is the religion of NER's election winner?	Central_Tibetan_Administration_general_election,_2016	after_election	religion
what is the subdivision rank of the person and things that shares the same name with NER?	French_brig_Amarante_(1793)	ship_namesake	subdivision_ranks
where is the alma mater of The person who affects NER patriot and republican?	Giuseppe_Garibaldi	influences	alma_mater
what is the house of The descendant of NER	Prince_Franz_Wilhelm_of_Prussia	issue	house
what is the occupation of the lyricist of the title of 2013 Super Junior album NER?	Hero_(Super_Junior_album)	title	music	education_level
which label does the author of NER belong to?	Girls_Just_Wanna_Have_Fun_(Shaggy_song)	chronology
what is the subdivision name of the northwest of NER?	The_Palm_of_Cervello	nw	nw
what is the type of the sponsor of NER?	Super_Bowl_LI_halftime_show	sponsor	type
what is the area of the northwest location of NER Spain	The_Palm_of_Cervello	nw	nw
what is the timezong of the northwest of NER?	La_Morera_de_Montsant	nw
which league does the operator of NER's venue play for?	2016–17_Veria_FC_season	stadium	tenants	league
what is the management level of NER ship name	HMCS_Parry_Sound	ship_namesake	subdivision_type
what is the country of the singer of the language NER song of a geographic region?	Languages_of_Papua_New_Guinea	extra	nation
what is the name of the administrative district of Le nord-est de Le Stade where the NER	2010-11_NFL_playoffs	stadium	northwest	northeast
NER's candidate alias who's successor	Gedling_(UK_Parliament_constituency)	candidate	after	successor
what are the awards for people or things with the same name as the Arleigh Burke-class destroyer, the battleship NER of this class	USS_Arleigh_Burke	ship_namesake	awards
what is the timezong of the southwest of the city that NER lives in?	National_Register_of_Historic_Places_listings_in_Weld_County,_Colorado	city	southwest	timezone
who is the heir of L'avant Predecessor of NER	Charles_the_Fat	issue
who is the predecessor of Election after NER	Election_Committee_(Legislative_Council_constituency)_by-election,_2001	after_election	district
what is the job of The name of the ship of NER	French_cruiser_Lavoisier	ship_namesake
what came before The Children of the NER	Joseph_Chamberlain	children	predecessor
what is the name of the administrative division of West of NER's place of death	Henry_Brewerton	death_place	capital
who is the predecessor of the person, thing, thing with the same name as NER?	Spanish_frigate_Admiral_Juan_de_Borbón	ship_namesake	predecessor
what is the profession of NER Timeline	Themes_from_Calmi_Cuori_Appassionati	chronology	profession
what is the religion of NER's candidate graduate school?	England_and_Wales_police_and_crime_commissioner_elections,_2012	candidate	predecessor
what is the level of management at North East Stadium where NER played a football team season?	2015_Copa_do_Brasil_First_Round	stadium	northwest	subdivision_type
which title does the inaugural of the title of NER own?	Paulo_Muwanga	title	inaugural	title
what time zone is the location south of NER in?	The_Vall_d'en_Bass	s	e
where is the birthplace of the person named NER	Leakey_(crater)	eponym	religion
what is the occupation of the author of NER?	Identity_(Zee_album)	chronology	occupation
where is the lyrics of the title of NER educated?	Ride_Me_(album)	title	genre
what is the profession of Lyrics of The title of NER?	Hero_(Super_Junior_album)	title	genre
what is the college of the coach of NER?	Russia_women's_national_volleyball_team	coach
what is the job of the lyrics of the title of NER?	Ride_Me_(album)	title	genre
where is the alma mater of NER located?	Albert_Camus	alma_mater	city
which place does the important event of NER take place?	2010–11_Queens_Park_Rangers_FC_season	s	team
what is the classification level of people, things and things with the same name as NER?	USS_Torchwood_(AN-55)	ship_namesake	subdivision_ranks
what awards The first of NER's title won?	Nathan_Farragut_Twining	title	first
what is the zoning of the location in the southeast of NER's home field?	2016-17_Oregon_State_Beavers_men's_basketball_team	home	southeast	subdivision_type
where is the title of Successor to Regent of NER queen of the Seleucid Empire?	Cleopatra_Thea	regent	title	title_leader
which series does the sponsor of the 2003 World Wrestling Entertainment pay-to-view event NER belong to?	Unforgiven_(2003)	event	promotions
what are the descendants of NER's principals?	Royal_Palace_of_Ficuzza	client	issue
which region does the event of NER belong to?	Archduchy_of_Austria	event	territory
which type does the sponsor of NER belong to?	Adopted_Daughter	sponsor	hq_location_city
which club does NER's head coach belong to?	2014–15_SC_Freiburg_season	s	clubs
what is the rank of the person and things that shares the same name with NER	USS_Hopper	ship_namesake	rank
where is the location province of NER seated?	Dhua_Kund	state/province	seat
what does the chief town of NER belong to?	Canton_of_Tremblay-en-France	chieftown	arrondissement
who are the children of the Election after NER	United_States_presidential_election_in_Minnesota,_1968	after_election	children
which rank does the people, things and things with the same name as NER belong to?	USCGC_Mallow_(WLB-396)	ship_namesake	subdivision_ranks
who is the leader of the event that occurs in NER	Germania_Superior	era
which place is called as the subdivision of the west of the northwest of NER?	Speaker,_Utah	northwest	west	subdivision_name
where is the one that is after election of NER located?	United_States_Senate_election_in_Vermont,_1980	after_election	state
who is the emperor of the country that uses NER	Uija_of_Baekje	
where is the constituency of The head of NER	Tasmanian_state_election,_1986	leader	constituency
who is the leader of the Northeast NER location	2014_Guangzhou_Evergrande_FC_season	location	west
which type of subdivision does the northeast of the home to NER belong to?	2015–16_Iona_Gaels_men's_basketball_team	home	northeast	subdivision_type
what classification level does the person or thing with the same name as NER belong to?	USS_Searaven_(SS-196)	ship_namesake
who is the heir of Election after NER	List_of_heads_of_state_of_Hungary	inaugural	after
where the religion of NER's ship's name comes from	President_El_Hadj_Omar_Bongo_(ship,_1978)	ship_namesake	predecessor
NER Catalonia, Spain, to which time zone its northwest location belongs	Gurb	nw
What's the deal with the 2017 Super Bowl halftime show NER's sponsor?	Super_Bowl_LI_halftime_show	sponsor	related
what is the name of the administrative division of the southwest of Northwest NER utah, united states?	Fairview,_UT	southwest	subdivision_name	title
what are the descendants of people, things and things with the same name as NER?	RV_Kronprins_Haakon	ship_namesake	issue
what is the subdivision type of the location of the location of NER?	2013-14_Lleida_Sports_season	location	n	subdivision_type
what the party of the NER leader is	Democratic_Party_(Indonesia)	
which rank does the people, things and things with the same name as NER belong to?	USS_Shrike_(MHC-62)	ship_namesake	subdivision_ranks
what do NER election winners do?	United_States_Senate_election_in_North_Carolina,_1998	after_election	occupation
what is the name of the administrative division of Capital of NER's location	Thebes,_Egypt	location	capital	subdivision_name
in which country is the representative of the venue of NER?	1978_Kangaroo_tour_of_Great_Britain_and_France	stadium	south	west
NER what is the positioning of its coach	2014–15_SC_Freiburg_season	s	position
what club Captain of NER club worked in	2015_UEFA_European_Under-19_Championship_squads	club	coach	clubs
where was the person or thing with the same name as NER born	Otto_Hahn_(ship)	ship_namesake	birth_place
where does the title of NER belong to which time zone	George_Wallace_Jr.	title	southwest	southeast
NER, the early dynastic confederation of ancient Egypt (c. 3150 AD), who was its leader's predecessor	Thinite_Confederacy	leader	successor
what is the type of manager of NER	Coca-Cola_Topnotchers	sponsor	type
what zip code is used for people, things and things with the same name as NER	USS_Winnemucca_(PC-1145)	ship_namesake	postal_code_type
who Will Be Your Next NER Question Club Next	Bohemia	seat	source
what is the type of NER Related Things manufactured and sold by apple computer, inc.?	IMac_G3	related	type
who is the heir to NER's ship name	USS_Windom_(1896)	ship_namesake	after
The location of the football team for a season NER is in which time zone does the northern city belong?	2011-12_Valencia_CF_season	s
where is the birthplace of the commander of NER?	Boundary_Creek,_New_Brunswick	seat_type
which countries are the sources of the names of the cities that participate in the NER of the Wikimedia list article	National_Register_of_Historic_Places_listings_in_Tennessee	city	named_for
Did you know that the common languages of Pays de NER were participating?	Conrad,_Count_Palatine_of_the_Rhine	after	before
who is the leader of the Northwest of The stadium where the NER took place	2008-09_Chelsea_FC_season	stadium	established_event
what is the division of the southern city of NER?	Carmen,_Barcelona	s	subdivision_type
what is the religion of the descendants of NER?	Pyinbya	issue	house
which label does the event of NER work for?	UEFA_Women's_Euro_2013_Final	event	label
1998 single, what's the draft team of the creators of NER featuring Shaquille O'Neal, dj Quick, Lord Tariq and Peter Gunz	The_Way_It's_Goin'_Down	chronology	team
what is the occupation of the author of NER?	Qualquer_Coisa	chronology	format
what is the rank of the person and things that shares the same name with NER?	SS_Rochambeau	ship_namesake	death_place
who is the successor of the one that is after election of NER?	United_States_Senate_election_in_West_Virginia,_2014	after_election	successor
what the battle of NER's ship's name is	USNS_Lewis_B_Puller_(T-ESB-3)	ship_namesake	battles
what is the stadium that hosted the Division of NER	2009-10_in_Australian_soccer	division
what is the occupation of the successor of the author of NER?	My_Love:_Essential_Collection	extra	occupation
who is influenced by the origin of NER's name?	Cezanne_(crater)	eponym	influenced
where was the last NER-related match of the UEFA Euro 2000 held?	UEFA_Euro_2000_Final	event	stadium
where do the leaders of the NER take office	French_regional_elections,_2015	leader	office
what is the name of the administrative district of Northeast of World NER Day Venue	Seattle_Arctic_drilling_protests	place	south	subdivision_name
what branch NER's ship name belongs to?	USS_Montgomery_(1813)	ship_namesake	branch
what time zone uses Area covered by the NER location	2013–14_Diósgyőri_VTK_season	location	seat	timezone_dst
what is the country of NER's alma mater?	Gerard_M_Burns	alma_mater	country
in which city is the operator of the venue of NER?	2013-14_Luton_Town_FC_season	stadium	operator	city
NER, Wikimedia listing article, which team the captain of their club location plays for	2010_FIFA_World_Cup_squads	club	coach	currentclub
what is the timezong of the northwest of NER?	Siurana,_Alt_Emporda	nw	nw
A town in Sevier County, Utah, United States what is the area of NER, the location in the northwest, and the location in the southwest?	Koosharem,_UT	northwest	northeast	subdivision_name
which title does the leader of NER own?	Albanian_Kingdom_(1928–39)	leader	issue
where is the city of Alma mater from NER	Jill_Garner	alma_mater	city
what classification level do people, things and things with the same name as NER belong to?	HMS_Sparrow_(1828)	ship_namesake
which party does the legislature in the birthplace of NER belong to?	Reuss_(river)	source1_location	upper_house	party
who is the leader of NER's ship name	Type_626_tanker	ship_namesake	leader_name
who are the generals participating in the The name of the NER ship	Nile_(1798_ship)	ship_namesake	commander
which type does the location of the tenant of NER belong to?	Shandong_Stadium	
what is the type of artist who sings NER songs	I'm_so_sorry	extra	before
who influenced NER's eponymous	Sherrington_(crater)	eponym	influences
the area covered by the NER Site Zoning Types	2015-16_Kansas_Jayhawks_women's_basketball_team	home	legislature	leader
what is the office of the one who is alongside NER	Steven_Poon	alongside	district
where did NER play work?	Steven_Poon	alongside	district
who is the publisher of NER's sponsor?	WWE_Breaking_Point	sponsor	publisher
who are the descendants of the person or thing with the same name as NER	French_ship_Charlemagne_(1852)	ship_namesake	issue
where the operator of Your next club is The stadium where the NER took place?	Germany_national_football_team_results_(2000–present)	stadium	after	tenants
what is the name of the alma mater of the person named NER?	Cayley_(crater)	eponym	work_institution
who is the president of Election after NER	United_States_Senate_election_in_Colorado,_2004	after_election	president
1998 single, who is the successor to the creator who sang NER by Shaquille O'Neal, dj Quick, Lord Tariq and Peter Gunz	The_Way_It's_Goin'_Down	chronology	after
what is the eponym of NER known for?	Volta_(crater)	eponym	known_for
where is the city of The operator of The stadium where the NER took place	2011-12_FA_Cup	stadium	southwest	constituency_westminster
who wrote the person and things that shares the same name with NER?	French_cruiser_Marseillaise_(1900)	ship_namesake
what is the operator of the venue of NER named?	Mauritius_national_football_team_results_(2010–19)	location	established_event
NER what is the time zone of the location in the southwest of its location	2013–14_FC_Utrecht_season	location	southwest	timezone_dst
what the profession of NER South is?	2014–15_SC_Freiburg_season	s	position
which title does the one that is after election of NER own?	United_States_Senate_election_in_Wyoming,_2000	after_election	title
who commanded the sponsor of NER?	Palm_of_Jerusalem	sponsor	author
who is the predecessor of the incident in which NER is involved?	Gurjara-Pratihara	event	issue
what is the level of management at Southern NER's location	2003_in_American_soccer	location	east	subdivision_type
who is NER's eponymous wife	Cori_(lunar_crater)	eponym
NER's election winner who's successor	Italian_general_election,_1874	after_election	after
who is the leader of the Province where the NER is located	Dhua_Kund	state/province	leader_name
which program is before the author of NER?	It's_a_SpongeBob_Christmas!_albums	chronology	previous_show
what is the time zone for the southern region of NER	Lliça_de_Vall	s	n
NER's location Northwest location leader's name is	1996_Guangzhou_Apollo_FC_season	location	west
what do the creators of NER do?	BEST_(After_School_album)	chronology
who manufactured NER's related products?	Nokia_Lumia_625	related	manufacturer
which place is called as the subdivision of the south of the city that NER lives in?	CBR_(AM)	city	south	subdivision_name
who is the heir of Occupied people of The title of NER	Laifour	
what is the origin of NER's name known for?	Shoemaker_(lunar_crater)	eponym
which timezone does the southeast of the home to NER belong to?	2015-16_Utah_State_Aggies_men's_basketball_team	home	southeast	timezone_dst
who are the current holders of the title of Explanation of NER	Taiwanese_municipal_elections,_2010	caption	after
who owns the operator of the stadium that NER takes place?	Nigeria_national_football_team_2012	stadium	operator	owner
who is earlier than the one that is after election of NER?	French_legislative_election,_1914	after_election	predecessor
where is the location of the Northwest Location of NER	2014–15_Bengaluru_FC_season	location	northwest	location
where is the title of Election after NER	Rangitikei_by-election,_1880	after_election	honorific_suffix
what is the profession of the singer who performed for omarion's album NER	Ollusion	extra	occupation
what type of company is NER's sponsor?	Academy_Award_(radio)	sponsor	company_type
NER's election winner whose last term was	German_presidential_election,_1994	after_election	profession
which eponymous domain belongs to NER	Van_der_Waals_(crater)	eponym	workplaces
whose ancestor is the commander of NER?	List_of_emperors_of_the_Han_dynasty	
which city does the alma mater of NER belong to?	Bob_Padilla	alma_mater
who is the successor of the one that is after election of NER?	South_Korean_presidential_election,_1980	after_election	successor
what is the honorary suffix of NER's ship name	HMS_Bligh_(K467)	ship_namesake	title
which dynasty does the legislature where the NER take place belong to?	2014_Davis_Cup_Europe/Africa_Zone_Group_I	venue	legislature	house
what is the leader name of the people, things and things with the same name as NER?	HMCS_Sherbrooke	ship_namesake	settlement_type
what is the name of the mother of a person or thing with the same name as NER?	USS_Troup_(1812)	ship_namesake	house
With NER it has the same name of people, things, things belong to which division	French_ship_Ville_de_Nantes	ship_namesake	subdivision_type
where is the location of the people, things and things with the same name as NER?	USS_LST-356	ship_namesake	seat
which office does the one that is after election of NER belong to?	National_Justice_Party_leadership_election,_2001	after_election	honorific_prefix
what's wrong with The Father of NER	Prince_Regent	
what the battle of NER's ship's name is	USNS_Lewis_B_Puller_(T-ESB-3)	ship_namesake	battles
who gave birth to the person and things that shares the same name with NER?	HMS_Osiris_(N67)	ship_namesake	parents
what is the club that the captain of the club that NER belongs to belongs to?	2015_UEFA_European_Under-19_Championship_squads	club	coach	clubs
where are the events included in the NER held?	2009-10_in_Australian_soccer	division
where are the events included in the NER held?	2009-10_in_Australian_soccer	division
what is the time zone of Northwest of NER	Vilanova_de_Segria	nw	timezone1_dst
who is the successor of the namesake of the Hamburg escort NER?	Leopoldus_Primus	ship_namesake	successor
who is earlier than the predecessor of the place that NER takes place?	2016_CBA_Playoffs	place	before	before
what is the subdivision type of the southwest of the city that NER lives in?	National_Register_of_Historic_Places_listings_in_Utah_County,_Utah	city	southwest	subdivision_type
what is the timezong of the location province of NER	Sakhalin_coal_mine	state/province
who is the mother of the successor of the descendant of the Prince of Denmark (born 1969) NER	Prince_Joachim_of_Denmark	issue	after	mother
who is the predecessor of the person and things that shares the same name with NER?/ who is the father of the person and things that shares the same name with NER?	French_cruiser_Georges_Leygues	ship_namesake	before
what is the subdivision rank of the person and things that shares the same name with NER?	HMS_Starling_(1829)	ship_namesake
where was NER's father's birthplace	Gyeongjong_of_Goryeo	
who is the manager of the operator of the stadium that NER takes place?	Mexico_national_football_team_schedule_and_results	stadium	tenants	stadium
who is the source of the NER vessel name information?	HMCS_Guelph	ship_namesake	source
what is the address of the operator of the venue where NER is held?	Czech_Republic_national_football_team_results	stadium	tenants	ground
which city is the birthplace of the captain of the club that NER belongs to?	2004_African_Cup_of_Nations_squads	club	before	name
what club Captain of NER's Club worked at?	2012_Africa_Cup_of_Nations_squads	club	coach	currentclub
what is the job of The name of the ship of NER	Croatian_training_ship_Andrija_Mohorovičić	ship_namesake
NER what is the name of the chairman of the tenant of its venue	1994_JEF_United_Ichihara_season	stadium	tenants	chairman
who founded the owners of NER club locations?	2006_World_Baseball_Classic_rosters	club	owner	founder
what is the name of the place west of NER's county?	Alcobendas	postal_code_type
what is the lyrics of the title of NER?	The_Beat_Goes_On_(Super_Junior_D&E_album)	title	genre
and who was influenced by the NER who or things with the same name	French_frigate_Descartes	ship_namesake	influenced
where is the heir of Generals of the participating NERs	Basilica_of_San_Magno,_Legnano	
what is the city of the operator of the NER venue?	2009–10_Olympiacos_FC_season	stadium	nw	s
which instrument does the author of NER play?	The_Milt_Jackson_Big_4	chronology
which dynasty does the successor of the descendant of NER belong to?	Charles_Louis,_Hereditary_Prince_of_Baden	issue	after	issue
which religion does NER's name belong to?	Spanish_frigate_Reina_Sofia	ship_namesake	religion
where is the title of The leader of NER	Albanian_Kingdom_(1928–39)	leader	issue
who the responsible actor for NER is?	Night_of_Champions_(2012)	sponsor	format
which title does the one that is after election of NER own?	French_legislative_election,_1893	after_election	title
where is the title of The name of the ship of NER	Greek_ironclad_Vasilefs_Georgios	ship_namesake	issue
NER, Wikimedia listing article, what is the positioning of the captain of its club location	UEFA_Euro_2012_squads	club	coach	currentclub
what classification level does the same name of NER belong to?	French_destroyer_Tigre	ship_namesake	subdivision_ranks
where is the alma mater of the people, things and things with the same name as NER?	French_submarine_Joule	ship_namesake	alma_mater
what is the title of the predecessor of the location of NER	2015_Shanghai_Greenland_Shenhua_FC_season	location	before	title
who is the spouse of the person, thing, thing with the same name as the sinking of an Egyptian-British built sloop during the 1948 war	Egyptian_referendum,_1956	before_election	nationality
Whose child is the name of NER?	French_submarine_Calypso	ship_namesake	parents
which place does the division that NER belongs to take place?	2009-10_in_Australian_soccer	division
in which city is the operator of the venue of NER?	2013-14_FA_Cup	stadium	tenants	location
what is the origin of NER's name?	Baco_(crater)	eponym	occupation
who is the next father of the descendants of NER?	Maria_Theresa_of_Naples_and_Sicily	issue	next
who will be the next Election after NER	French_legislative_election,_1893	after_election	title
where is the address of The operator of The stadium where the NER took place	2011–12_Olympiacos_FC_season	stadium	tenants	city
who does the origin of NER's name influence?	Belinskij_(crater)	eponym
which club currently belongs to Captain of NER's club	2009_FIFA_U-20_World_Cup_squads	club	coach	currentclub
who is the father of Le chef de NER	Duchy_of_Anhalt	leader	father
what is the type of creator of NER	Gone_Girl_(soundtrack)	chronology	genre
what is the predecessor of the operator of the position of the NER of the American college football team?	2014_BYU_Cougars_football_team	location	before
what is the name of the administrative division of The name of the vessel of NER	HSwMS_Harnosand_(K33)	ship_namesake	subdivision_type
what the problem of The Descendant of NER is	Leopold_IV,_Duke_of_Anhalt	issue	issue
which timezone does the southwest of the locale of NER belong to?	Billings_Metropolitan_Transit	locale	southwest	timezone_dst
The field the person whose name is used to name the NER belongs to	Kamerlingh_Onnes_(crater)	eponym	workplaces
which party does the legislature where the NER is held belong to?	2005_Davis_Cup_World_Group_Play-offs	venue	legislature	party
who is the next generation of the title of NER?	30_Rock_(season_1)	title	next	next
what is NER's eponymous legislature	Harald_V_of_Norway	
what club Captain of Tenants of NER worked at?	Atletion	tenants	club	city
what is the job of the lyrics of the title of NER?	The_Beat_Goes_On_(Super_Junior_D&E_album)	title	genre
what the agency headed by The head of NER is?	House_of_Assembly_of_Saint_Vincent_and_the_Grenadines	leader	order
what is the subdivision type of the northeast of the death place of NER?	Willis_H_Downs	death_place	northeast	subdivision_type
which title does the cause of NER belong to?	2014_Enugu_Government_House_attack	place	seat_type
which type of subdivision does the northwest of NER belong to?	Eamon_deValera	children
what are the titles of the incumbent incumbent of the title of Bangladesh President NER?	Shahabuddin_Ahmed	title	incumbent	title
what club Captain of NER's Club worked at?	2015_UEFA_European_Under-17_Championship_squads	club	coach	clubs
what the battle of NER's ship's name is	French_ironclad_Courbet	ship_namesake	rank
where is the birthplace of the city of Captain from NER's club	2010_FIFA_World_Cup_squads	club	city	west
who the descendants of NER's ship's name are?	Queen_Charlotte_(1812_ship)	ship_namesake	issue
who is the descendant of the father of NER?	Princess_Pingyang_(Han_dynasty)	father	issue
what classification level do people, things and things with the same name as NER belong to?	HMNZS_Moa_(T233)	ship_namesake	subdivision_ranks
what is the level of management at the Northeast of NER Site	2014-15_Northern_Colorado_Bears_women's_basketball_team	home	northwest	subdivision_type
what time zone does NER's Northwest location belong to?	Espot	nw	subdivision_type
who is the male parent of the successor of the descendant of NER?	Josephine_of_Leuchtenberg	issue	after	father
what is the time zone of a person or thing with the same name as NER	HSwMS_Harnosand_(K33)	ship_namesake	subdivision_type
what time zone is used for the administrative center of the parent of NER, a mountain range in southeastern Poland	Pogorze_Bukowskie	parent	seat	timezone
which district does the west of the location of NER belong to?	2014–15_Evian_Thonon_Gaillard_FC_season	location	w	arrondissement
who operates the successor of the stadium that NER takes place?	2014-15_UEFA_Europa_League_knockout_phase	stadium	after	owner
which product belongs to the team that won NER	Thomas_Pages	team
what is establishedEvent in NER country	2014_Gulf_Cup_of_Nations	stadium	before
what is the capital (or provincial capital) of the location in the northeast of the region to which NER belongs	Cordillera_Central_(Luzon)	region	southwest	capital
which subject does the one that is influenced by NER belong to?	Rozdzielna	subdivision_type
which type of subdivision does the south of the southwest of NER utah, united states, belong to?	Clarkston,_UT	southwest	south	subdivision_type
which party does the one that is after election of NER belong to?	Iranian_legislative_election,_1956	after_election	before
where is the mayor of NER	Canton_of_Bertincourt	chieftown
what is the name of the leader of NER with the same name?	HMCS_Ville_de_Quebec_(K242)	ship_namesake	leader_name
what is the club in which Captain of NER's club works?	2009_FIFA_U-20_World_Cup_squads	club	coach	currentclub
what is the religion of NER's election winner?	Colombian_presidential_election,_1998	after_election	religion
which religion does the commander of NER belong to?	Keith_Williams_(offensive_lineman)	college	location
what is the author of NER	They_All_Went_to_Mexico	chronology	occupation
which institution is the alma mater of American sculptor NER affiliated to?	Wayne_Chabre	alma_mater	affiliations
who is the successor of NER's general	List_of_emperors_of_the_Han_dynasty	
who is the predecessor of the people, things and things with the same name as NER?	French_ship_Alexandre_(1857)	ship_namesake	title
which language does the lyrics of the title of NER use?	Hero_(Super_Junior_album)	title	music	language
what are the descendants of NER's namesake?	King_George_(1785_ship)	ship_namesake	issue
who is earlier than the one that is after election of NER?	Manila_local_elections,_2016	after_election	before
which one is known as the prime minister of the parent of NER?	Francis_Russell,_Marquess_of_Tavistock	parents	primeminister
what is the ideology of the title of NER forward	Holger_K_Nielsen	before	title	ideology
NER's election winner whose last term was	Rangitikei_by-election,_1880	after_election	honorific_suffix
what city is the alma mater of American basketball coach NER?	Greg_Gard	alma_mater	city
NER, 1892, who is the successor to the winner of an election held in Japan in 1892	Japanese_general_election,_1892	after_election	after
who leads the people, things and things with the same name as NER?	HMCS_Sherbrooke	ship_namesake	leader_name
what constituency is NER's sponsor?	Stafford_150	sponsor	constituency_westminster
where did NER's eponymous religion come from?	Aryabhata_(crater)	eponym	region
which type of subdivision does the northeast of the city that NER lives in belong to?	National_Register_of_Historic_Places_listings_in_San_Juan_County,_Utah	city	northeast	subdivision_type
which region does the event involved in NER belong to?	Tanukhids	event	place
what are the titles of leaders of people, things and things with the same name as NER?	Type_626_tanker	ship_namesake	leader_title
who is the successor of the person, thing, thing with the same name as the ship NER?	French_cruiser_Georges_Leygues	ship_namesake	successor
where is the administrative center of Northern NER's location	State_highways_serving_Virginia_state_institutions	location	seat
what time zone uses NER ship name	HSwMS_Harnosand_(K33)	ship_namesake	subdivision_type
NER what are the products of its sponsors	2011_Penrith_Panthers_season	sponsor
what the predecessor of The Father of NER is	princess_of_qingdu	father
where the birthplace of the city is from Captain of The NER Club	1999_FIFA_World_Youth_Championship_squads	name
what is the flag event established in the country where NER is located?	2014_Gulf_Cup_of_Nations	stadium	before
which battle is the people, things and things with the same name as NER involved?	HMS_Bramham_(L51)	ship_namesake	battles
what is the occupation of the person whose name is used to name the NER?	Tikhonravov_(crater)	eponym
what is the name of the Northwest administrative division of NER	Calafell	nw	subdivision_type
what is the people, things and things with the same name as NER?	Pizarro_(brigantine)	ship_namesake	honorific_prefix
what is the occupation of the founder of NER's team?	Giancarlo_Fisichella	team	after	title
which club does the captain of the club that NER belongs to belong to?	1999_FIFA_World_Youth_Championship_squads	club	manager
what came before The Children of the NER	Joseph_Chamberlain	children	predecessor
who is the successor of the person and things that shares the same name with NER	SMS_Hindenburg	ship_namesake	successor
NER's election winner whose last term was	Italian_general_election,_1992	after_election	appointer
who is the leader of the North West NER location	2013_Guangzhou_Evergrande_FC_season	location	west	leader_name
NER's location what is the title of the location leader in the North West?	Taltoli_Jama_Mosque	location	northwest	leader_title
what is the religion of NER's spouse's spouse	Tyti	spouse	children	religion
Whose children are the people in NER?	Hades_in_popular_culture	name	children
where is the person and things that shares the same name with NER seated?	USS_Rawlins_(APA-226)	ship_namesake	northeast
who is the heir of Election after NER	Town_of_New_Plymouth_by-election,_1865	after_election	successor
what is the name of the administrative division of The North of NER Millionaires	National_Register_of_Historic_Places_listings_in_Box_Elder_County,_Utah	city	west	subdivision_name
what is the classification level of a person or thing with the same name as NER	USS_Skimmer_(AMCU-41)	ship_namesake	image_caption
which party does the one that is after election of NER belong to?	Persian_legislative_election,_1906	after_election
who is the successor of the commander of NER	Vantage_Point_(film)	studio
where is the city of Alma mater from NER	Art_Peck	alma_mater
what is the title of the person and things that shares the same name with NER?	HMS_Black_Prince_(81)	ship_namesake	title
what is the zoning of the location in the west of where NER died?	Michael_William_Hyle	death_place	west	subdivision_type
who are the generals participating in the The name of the NER ship	French_brig_Lodi_(1797)	ship_namesake	commander
what type of subject is NER	The_Wizarding_World_of_Harry_Potter_(Universal_Studios_Japan)	theme	genre
NER, Bismarck-class battleship, what is the award for its namesake	German_battleship_Tirpitz	ship_namesake	title
what NER's successor club location is named for	Henry_Rono	after	club	name
what is the person and things that shares the same name with NER known for?	USS_Gatling	ship_namesake
what is the specialty of Election after NER?	German_presidential_election,_1994	after_election	profession
where is the place of death of the person whose name was used to name NER	Haldane_(lunar_crater)	eponym	education
what is the label of The area where NER is used?	Zengovarkony	subdivision_type
where is the title of Election after NER	United_States_Senate_election_in_Georgia,_2014	after_election	title
who will be your next club from The stadium where the NER took place next	2014_AFC_Champions_League_knockout_stage	stadium	after	after
what classification level does the same name of NER belong to?	Marsouin_(1788_ship)	ship_namesake	subdivision_ranks
what is the next term of the father of NER	Kondagaon	
Part of what is the person, thing, thing with the same name as NER	SMS_Novara_(1850)	ship_namesake	partof
who is the father of NER's ship name	HMS_Black_Prince_(81)	ship_namesake	father
who takes the place of the father of NER?	Northern_Zhou_Dynasty	
what time zone uses Northern NER Millionaires	List_of_American_football_stadiums_by_capacity	city	northwest	postal_code_type
who are the generals participating in the The name of the NER ship	USS_Chancellorsville	ship_namesake	commander
who leads the parliament of seats held by NER?	Scottish_Conservative_Party	seats1_title	leader
where the alma mater of NER's ship name is	Otto_Hahn_(ship)	ship_namesake	alma_mater
which team does the captain of the NER club location play for?	2015_UEFA_European_Under-17_Championship_squads	club	coach	clubs
which office does the leader of NER belong to?	French_National_Convention_election,_1792	leader	office
who will be the next Election after NER	Estonian_election_election,_2003	after_election
which club does the captain of the NER club location now belong to?	2012_Africa_Cup_of_Nations_squads	club	coach	currentclub
what important positions Election has after NER	National_Justice_Party_leadership_election,_2001	after_election	honorific_prefix
which institution is NER's alma mater affiliated to?	Patricia_Clavin	alma_mater	affiliations
who led NER's events	Germania_Superior	era
where is the chief of The main organ of the chiefs of NER	Doge_of_Genoa	
who leads the countries and regions affected by NER	1857_Basilicata_earthquake	countries_affected	leader
NER, Baron of Ireland, where is his alma mater stationed	Sir_George_Francis_Osborne,_16th_Baronet	alma_mater	ceremonial_chief
what time zone does the southern city of NER belong to?	Osor,_Girona	s	n
what is the occupation from which the name NER comes from?	Neruda_(crater)	eponym	profession
what the Legislature is in The Land of NER	HK_MK_Bled	league
who is the president of The name of the ship of NER	USRC_Dexter_(1830)	ship_namesake	president
what is the region of the person or thing with the same name as NER?	HMCS_Sherbrooke	ship_namesake	subdivision_name
what are the products of NER's sponsors	Hisense_4K_TV_300	sponsor
who will be people, things and things with the same name as NER next	Bermejo_Department,_Chaco	capital	blank_info
what is the previous generation of NER's election winner?	Bulgarian_election_election,_1986	after_election
what is the subdivision rank of the person and things that shares the same name with NER?	USCGC_Salvia_(WLB-400)	ship_namesake
what is the level of management at the southwest of NER's location	Business_routes_of_Interstate_94	location	southwest	subdivision_type
what is the provincial capital of the location in the southwest of the birthplace of NER?	River_Inny_(Leinster)	source1_location	southwest	subdivision_name
who is the predecessor of the leader of the label of NER?	Hong_Kong_local_elections,_2015	label	leader1_name	predecessor
where is the city of The operator of The stadium where the NER took place	2014–15_Tottenham_Hotspur_FC_season	stadium	operator	city
what is the organization run by Election after NER	List_of_heads_of_state_of_Hungary	body
what time zone uses Area covered by the NER location	2015_Nepal_National_League	location	seat	timezone
what is the occupation of the origin of NER's name?	Mendes_Pinto_(crater)	eponym
what type of NER Timeline	Nuits_de_la_Fondation_Maeght_(Sun_Ra_album)	chronology
which team does the captain of the club that NER belongs to belong to?	2014_FIFA_World_Cup_squads	club	coach	currentclub
who is before the parent of NER	USS_Franklin_(1795)	ship_namesake	predecessor
what are the descendants of NER's namesake?	King_George_(1785_ship)	ship_namesake	issue
what are the affiliates of Alma mater of NER	Blas_C._Silva_Boucher	alma_mater
who leads the cause of NER?	First_cabinet_of_Louis_Napoleon	
what is the club in which Captain of NER's club works?	2015_UEFA_European_Under-19_Championship_squads	club	coach	clubs
what clubs did NER's coaches join?	Russia_women's_national_volleyball_team	coach
NER which district does its main town belong to	Canton_of_Gagny	chieftown
who is the manufacturer of things related to NER?	Kinder_Joy	related	manufacturer
which ethnic group does the previous generation of NER's lyricist belong to?	Prudence_Liew_(album)	lyrics	before
where the birthplace of NER's coach is?	Han_Cong	coach	birth_place
what is the field of people whose names are used to name NER	Ehrlich_(crater)	eponym	field
what era of NER's ship's name is?	HMS_Malaya	ship_namesake	common_languages
who managed the operator of the stadium that NER takes place?	Mauritius_national_football_team_results_(2010–19)	stadium	operator	manager
where is the city of The operator of The stadium where the NER took place	2016–17_UEFA_Europa_League_qualifying_phase_and_play-off_round	stadium	northwest	subdivision_type
what time zone is in Northwest of NER	Tornabous	nw	timezone1_dst
who do the job after the one that is after election of NER?	Persian_legislative_election,_1906	after_election
what is the management level of Northwest of NER	Montornes_del_Valles	nw	subdivision_type
where is the borough of The main city of NER	Canton_of_Remiremont	chieftown
what is the management level to the southwest of NER's place of death	James_H_Wilson	death_place	southwest	subdivision_type
what is the subdivision name of the southwest of the home to NER?	2014–15_Utah_Utes_men's_basketball_team	home	southwest	subdivision_name
what is the religion of the leaders of NER?	London_local_elections,_2018	leader	title
what is the title of the person and things that shares the same name with NER	French_cruiser_Georges_Leygues	ship_namesake	title
what is the positioning of the captain of the NER club location	UEFA_Euro_2016_squads	club	coach	position
which division does the southern city of NER belong to?	Garrigues_(comarca)	s	postal_code_type
what is the nickname of Alma mater of NER	Mark_Van_Ameyde	alma_mater
which draft team does the writer of the title of NER belong to?	List_of_Star_Trek:_Deep_Space_Nine_episodes	title	story
which royal house does the person and things that shares the same name with NER belong to?	Princess_Selandia	ship_namesake	succession
do You Know what Language Lyrics Of NER's Title Is Using	Ride_Me_(album)	title	lyrics
what is the classification level of people, things and things with the same name as NER?	Marcus_Licinius_Crassus_(consul_30_BC)	
what is the religion of the country of birth of NER	Gabriel_Urpi	
what does the successor of the descendant of NER succeed?	Princess_Louise_Caroline_of_Hesse-Kassel	issue	succession
NER, a genus of insects that represents which time zone a location in the west belongs to	Tanaecia	image_caption	southwest	northeast
where does the source of the NER name belong?	Volta_(crater)	eponym	field
what is the government type of the southwest of the stadium that NER takes place?	Uzbekistan_national_under-20_football_team_results	stadium	southwest	government_type
what is the division of people, things, and things with the same name as NER?	HMCS_Guelph	ship_namesake	subdivision_type
who is the male parent of the leader of NER?	Monarchy_of_the_North	leader	burial_place
what is the name of the mother of a person or thing with the same name as NER, a ship	HMS_Alexandra_(1875)	ship_namesake	mother
who is the predecessor of the previous generation where NER was held?	2012_Chinese_FA_Cup	stadium	before	before
which city does the operator of the stadium that NER takes place belong to?	2016–17_Sheffield_Wednesday_FC_season	stadium	tenants	location
what is the timezong of NER's southern region?	Pancakes	s
what is the occupation of the successor of the author of NER?	My_Love:_Essential_Collection	extra	occupation
who are the founders of The National Team location of NER	Jay-Jay_Okocha	nationalteam	location	east
who is the wife of The leader of NER	Albanian_Kingdom_(1928–39)	leader	religion
NER's location what time zone does the location in the northeast belong to?	Sakura-Con	location	southwest	timezone
NER what are the titles of location leaders in its location Northwest	2014–15_Bengaluru_FC_season	location	title
which battle is the person and things that shares the same name with NER involved?	HMS_Bigbury_Bay_(K606)	ship_namesake	battles
what is the profession of NER's ship's name	French_battleship_Danton	ship_namesake	title
what is the timezong of the southeast of the location of NER?	France_national_football_team_results_(2000–present)	location	southeast	timezone
which royal house does the person and things that shares the same name with NER belong to?	Egyptian_referendum,_1956	before_election	nationality
and NER what is the war in which a person or thing with the same name participated	USS_Bainbridge_(DDG-96)	ship_namesake	battles
Part of what is the person, thing, thing with the same name as NER	French_ship_Austerlitz_(1852)	ship_namesake	partof
who will be the next Election after NER	Spanish_general_election,_1931	after_election	before
what is the origin of NER's name?	Hevelius_(crater)	eponym	religion
what is the famous work of the person named NER?	Marconi_(crater)	eponym	known_for
where is the title of The name of the ship of NER	HMS_Black_Prince_(81)	ship_namesake	title
what is the area of a mountain range in Utah County, Utah, USA, where the location northeast of the city NER is located.	Lake_Mountains	city	northeast	subdivision_name
what is the name of the leader of the eastern location of a sports game NER?	2016_AFC_Champions_League_group_stage	stadium	east	leader_name
who is the President of Election after NER	Abkhazian_presidential_election,_2014	after_election	primeminister
what are the important positions of Election after NER	United_States_Senate_election_in_Vermont,_1980	after_election	office
what is the famous eponymous work of NER	Volta_(crater)	eponym	known_for
which party belongs Election after NER	Guatemalan_general_election,_2011	after_election	party
where is the city of Alma mater from NER	James_Haven	alma_mater	city
NER, Wikimedia listing article, what is the region of the location northwest of the city where it belongs	National_Register_of_Historic_Places_listings_in_Salt_Lake_County,_Utah	city	northwest	subdivision_name
where the religion of Election after NER came from	Danish_general_election,_2007	after_election	title
which party does NER's namesake belong to?	USS_Poinsett_(1840)	ship_namesake	party
where did the commander of NER die?	Boundary_Creek,_New_Brunswick	seat_type
what time zone uses Northern NER Site	2014-15_Santa_Clara_Broncos_women's_basketball_team	home	north	timezone_dst
who founded the record company NER belongs to?	Destination_Games	founders
who is the successor of NER's namesake?	Spanish_cruiser_Emperador_Carlos_V	ship_namesake	after
what is the reason for the person, thing, and thing with the same name as Bakuden Porcelain NER?	Type_Long_March_cargo_ship,_medical_evacuation	ship_namesake	result
who rented the venue of the NER club	2015_WBSC_Premier12_rosters	club	stadium	tenants
what is the leader title of the person and things that shares the same name with NER?	HMCS_Levis_(K400)	ship_namesake	northwest
who does the name included in the NER influence?	Empedocles_(volcano)	name	influenced
where did the person or thing with the same name as NER die?	RV_Neil_Armstrong_(AGOR-27)	ship_namesake	death_place
NER, Wikimedia listing article, where is the birth city of the captain of his club location	UEFA_Euro_2012_squads	club	coach	currentclub
where is the birthplace of the person and things that shares the same name with NER?	French_cruiser_Foch	ship_namesake	birth_place
who is the actor of Theme du NER	Skull_Island:_Reign_of_Kong	theme	studio
who are the generals involved in the Events in NER	Empire_of_China_(1915–16)	event
which district does the north of the location of NER belong to?	2014_Maryland_Terrapins_men's_soccer_team	location	north	constituency_westminster
what is the language of the lyricist of the title of NER	Ride_Me_(album)	title	lyrics	language
who is the predecessor of the one that is after election of NER?/ who is the father of the one that is after election of NER?	Estonian_election_election,_2003	after_election
who is the spouse of the people, things and things with the same name as NER?	Fortitude_(1780_EIC_ship)	ship_namesake	spouse
which place is called as the subdivision of the caption of the stadium that NER takes place?	Wales_women's_national_rugby_union_team	stadium	caption	subdivision_name
what is the alma mater of the person whose name is used to name NER	Schliemann_(crater)	eponym	alma_mater
NER what is the division of the area to the northwest of it	Oliola	nw	postal_code_type
what club Captain of NER's Club worked at?	2015_UEFA_European_Under-17_Championship_squads	club	coach	clubs
The name of the venue leader in the east of the football match NER is	2013_AFC_Champions_League_Final	stadium	east	leader_name
what is the party of the incumbent of the title of NER?	Peter_Mandelson	title	appointer	party
1915 events of the same name on the Royal Navy's Queen Elizabeth-class battleship NER	HMS_Malaya	ship_namesake	common_languages
which type does the person and things that shares the same name with NER belong to?	Italian_cruiser_Etna	ship_namesake	type
and NER who has been influenced by the person or thing with the same name	French_frigate_Descartes	ship_namesake	influenced
where is the event that starts the user of NER invented by sir hiram maxim in 1884, located?	Maxim_gun	used_by	event_start	location
what is the level of management at NER's North West Site	2015-16_BYU_Cougars_women's_basketball_team	place	east	subdivision_type
where the birthplace of NER's Coach is?	Roslin_Hashim	birth_place	capital
who is the predecessor of Election after NER	Central_Tibetan_Administration_general_election,_2016	after_election	predecessor
what team is the captain of the NER club location	2006_FIFA_World_Cup_squads	club	coach	currentclub
who was nominated by Candidate from The constituency of NER	Peter_Shiu	constituency	candidate	before
who is the descendant of the cause of NER	Henry_I,_Duke_of_Brabant	as
what the battle of NER's ship's name is	HMS_Bigbury_Bay_(K606)	ship_namesake	battles
which team does the captain of the NER club location play for?	2015_UEFA_European_Under-17_Championship_squads	club	coach	clubs
what is the deputy of the title of NER's successor called	Shō_Chu	
who is the wife of NER's ship name	Spanish_frigate_Admiral_Juan_de_Borbón	ship_namesake	spouse
which field does the person whose name is used to name NER work in?	Hevelius_(crater)	eponym	religion
who is the successor of the people, things and things with the same name as NER?	Harald_V_of_Norway	
where is the title of The name of the ship of NER	French_cruiser_Sully	ship_namesake	title
what is the instrument that the author of NER plays?	The_Piano_Style_of_Nat_King_Cole	chronology
which province is the location province of NER settled in?	Tevshiin_Govi_coal_mine	state/province
what language did the previous generation of NER's lyricists speak in?	Prudence_Liew_(album)	lyrics	before
what products do NER's sponsors have	Hisense_4K_TV_300	sponsor
what is the common language of the administrative region to which NER belongs?	Doge_of_Genoa	
who is the predecessors of Election after NER	United_States_Senate_election_in_Ohio,_1898	after_election	predecessor
what is the party of the legislature of the locale of NER?	Mediolanum_(train)	locale	legislature	party
what party did the predecessors of the previous generation of the French statesman (1907-2000) NER belong to	Pierre_Pflimlin	before	predecessor	party
NER's election winner who's successor	Spanish_general_election,_1931	after_election	title
what is the level of management at Northwest of NER	Vilada	nw
which dynasty does the legislature of the locale of NER belong to?	Transalpin	locale	legislature	house
what religion do NER's parents belong to?	Ronald_Lauder	parents
what is the subdivision type of the north of the location of NER?	Poland_at_the_2015_World_Speed_Skating_Championships	location	north	subdivision_type
NER what classification does the same name belong to?	French_destroyer_Chacal	ship_namesake	subdivision_ranks
who is issued by the people, things and things with the same name as NER?	Russian_cruiser_Gerzog_Edinburgski	ship_namesake	issue
where is the Alma Mater of Election after NER	United_States_Senate_election_in_Georgia,_2014	after_election	state
who is the predecessor of the one that is after election of NER?	French_legislative_election,_1914	after_election	predecessor
what the problem of The Descendant of NER is	William,_Prince_of_Hohenzollern	issue	predecessor
NER, the New York Knicks season in '70, the venue for one season of the National Basketball Association team, the New York Knicks, which division does the location in the northeast belong to?	1969-70_New_York_Knicks_season	place	east	subdivision_type
which field does the eponym of NER work in?	Michelangelo_(crater)	eponym	field
where is the constituency of the Northern NER location	1953–54_Colchester_United_FC_season	location	constituency_westminster
where is NER's eponymous Alma Mater	Haldane_(lunar_crater)	eponym	education
Whose name is NER's predecessor?	Spanish_cruiser_Don_Antonio_de_Ulloa	ship_namesake
who is the predecessors of NER's ship name	PS_Lugard_II	ship_namesake	before
what is the name of the administrative district of Le sud de NER	Prat_de_Comte	s	subdivision_name
NER, the tenant of the football team's successor for a season, its venue	2012_Gyeongnam_FC_season	stadium	after	tenants
who rules the father of NER?	kinga_goncz	
the area covered by the Events in NER	Tanukhids	event	place
where did the leader of the label of NER study?	Hong_Kong_legislative_election,_2016_(Hong_Kong_Island)	label	leader1_name	alma_mater
who is the descendant of the person, thing, thing with the same name as NER?	Queen_Charlotte_(1812_ship)	ship_namesake	issue
what dynasty does NER Nationality Life belong to?	Vanek_(surname)	region	legislature	house
which house does the legislature of the location of NER belong to?	1974_FIFA_World_Cup_qualifying_–_UEFA_Group_1	location	legislature	house
what is the branch of Election after NER	United_States_Senate_election_in_Nebraska,_2002	after_election	branch
what are the famous works of people, things and things with the same name as NER?	CS_Faraday_(1923)	ship_namesake	known_for
what is the name of the alma mater of the leader of NER?	United_Kingdom_general_election,_1886_(Ireland)	leader	honorific_prefix
what is the zoning of the place in the northwest of NER, a municipality in Spain	La_Morera_de_Montsant	nw
what is the subdivision name of the northeast of the death place of NER?	Michael_Angelo_Saltarelli	death_place	northeast	subdivision_type
what is the title of the leader of NER	Mongolian_legislative_election,_2016	leader	title
which place is called as the subdivision of the northeast of the birth place of NER?	John_Rostek	birth_place	north	subdivision_name
where is the birthplace of the person named NER	Volta_(crater)	eponym	place_of_birth
what is originated from the one that is after election of NER?	Persian_legislative_election,_1906	after_election
in which league The operator of The stadium where the NER took place will play?	2016–17_Sheffield_Wednesday_FC_season	stadium	before	after
what is the religion of the country that is spoken NER	Uija_of_Baekje	
which royal house does the person and things that shares the same name with NER belong to?	French_frigate_Cleopatra_(1781)	ship_namesake	regent
NER, the season of a football team, which country its position represents	2012-13_Chelsea_FC_season	location	established_event
in which area is the northwest location of NER Catalonia, Spain	arbucies	nw	subdivision_type
where is the northwest of the location of NER located?	San_Gabriel_Valley_Council	location	northwest	location
what are the titles of NER's generals?	United_States_Southern_Command	
where is the people, things and things with the same name as NER born?	Otto_Hahn_(ship)	ship_namesake	death_place
what is the subdivision rank of the person and things that shares the same name with NER?	Belgian_minehunter_Primula_(M924)	ship_namesake
what is the zoning of the location in the north of NER's home field during the American college basketball season?	2014-15_UC_Davis_Aggies_men's_basketball_team	home	north	subdivision_type
where is the birthplace of Election after NER	Haitian_presidential_referendum,_1961	after_election	birth_place
what is the constituency of the one that is after election of NER?	Hong_Kong_Island_by-election,_2000	after_election	honorific_suffix
what the job of NER's name is	List_of_awards_and_nominations_received_by_Billy_Ray_Cyrus	name	occupation
who is the manufacturer of things related to NER?	sony_xperia_z3+	related	manufacturer
what is the name of the administrative district of Southern NER	Bescano	s	subdivision_type
what time zone does the province of NER belong to?	Sakhalin_coal_mine	state/province
what is spoken by the lyrics of the title of NER?	The_Beat_Goes_On_(Super_Junior_D&E_album)	title	lyrics
what is the occupation of the singer who participated in Jolin Tsai's 2006 song NER	Dancing_Forever	extra	profession
who is the predecessor of NER-related stuff	Nokia_103	related	predecessor
what is the common language of the client of NER italy?	Doge's_Palace,_Genoa	client	common_languages
where is the place where the person or thing with the same name as NER died	Otto_Hahn_(ship)	ship_namesake	death_place
what is the location country of the image caption of the town of NER	List_of_blue_plaques_erected_by_the_Royal_Society_of_Chemistry	subject	caption
who did a job before the one that is after election of NER?	South_African_general_election,_1977	after_election	predecessor
what is the region of the person or thing with the same name as NER?	HMCS_Esquimalt_(J272)	ship_namesake	subdivision_name
who will host NER's Title Podcast next?	The_Complete_Guide_to_Everything	title	after	occupation
what is the address of the operator of the venue where NER is held?	2014–15_Olympiacos_FC_season	stadium	established_event	title_leader
which place is called as the subdivision of the east of the parent of NER	Pogorze_Bukowskie	parent	seat	subdivision_name
In NER Catalonia, Spain, what is the zoning of the place to the northwest of it	Corbera_de_Llobregat	nw
what are the descendants of people, things and things with the same name as NER?	Queen_Charlotte_(1812_ship)	ship_namesake	issue
what is the northwest where the national team of the ukrainian football player NER is hosted	Demetrius_Vikelas	
which product belongs to the sponsor of NER	Louis_Schwitzer_Award	sponsor	products
who leads the legislature of the northeast of NER india?	Darjeeling_district	northeast	legislature
where did the person and things that shares the same name with NER study?	USRC_McLane_(1832)	ship_namesake	title
where is NER's eponymous Alma Mater	Schliemann_(crater)	eponym	alma_mater
where is NER's eponymous Alma Mater	Fredholm_(crater)	eponym
what is the postcode of the south west location of NER	2015_Seattle_Sounders_FC_season	location	north	subdivision_name
who created the products or works related to NER	1990_DFB-Supercup	stadium
who is the heir to NER's ship name	Cornwallis_(1787_ship)	ship_namesake	honorific_prefix
which rank does the person and things that shares the same name with NER belong to?	French_brig_Cygne_(1806)	ship_namesake	subdivision_ranks
who is issued by the client of NER?	Egelund_House	client	issue
where the birthplace of the city is from Captain of The NER Club	2012_Africa_Cup_of_Nations_squads	club	ground	tenants
who the creator of The NER Related Thing is	1990_DFB-Supercup	stadium
which religion does the country that uses NER follow?	Uija_of_Baekje	
which country is the image caption of the location of NER located?	Romania_national_football_team_results_(1980–99)	location	nationality
which club does the captain of the club that NER belongs to belong to?	2009_FIFA_U-17_World_Cup_squads	club	before	name
which general leads NER-related events	Empire_of_China_(1915–16)	event
which type of subdivision does the north of the location of NER belong to?	United_States_at_the_2015_World_Speed_Skating_Championships	location	north	subdivision_type
what are the subdivision ratings of the NER ship name	HNoMS_Myg	ship_namesake	subdivision_ranks
who owns your next club from The stadium where the NER took place	1997–98_Juventus_FC_season	stadium	after	owner
what is the office of the one that is after election of NER?	Election_Committee_(Legislative_Council_constituency)_by-election,_2001	after_election	district
where does the NER team come from	McLaren_Technology_Group	key_people
NER, the American college basketball season, which division is the southern part of its home field?	2016-17_Southern_Utah_Thunderbirds_men's_basketball_team	home	south	subdivision_type
who is the owner of the successor of NER's venue?	2013–14_UEFA_Champions_League_group_stage	stadium	owner	other
what is the province of NER's alma mater?	Jacqueline_de_Chambrun	alma_mater	province
where is the Alma Mater of Election after NER	Lithuanian_election_election,_2000	after_election	title
what is NER Coach University	Russia_women's_national_volleyball_team	coach
what is the deathpalce of the person and things that shares the same name with NER?	Spanish_cruiser_Don_Antonio_de_Ulloa	ship_namesake
what is the subdivision name of the southwest of the northwest of NER?	Scofield,_UT	northwest	southwest	subdivision_name
what is the club in which Captain of NER's club works	2004_African_Cup_of_Nations_squads	club	before	name
NER's events speak the common language	Kingdom_of_Galicia_and_Lodomeria	event	common_languages
what is the timezone used by Club that Est de NER is part of	Figols_i_Alinyà	n	e	timezone
what is the timezone used by Corps of NER's Title	George_Wallace_Jr.	title	capital
who is the male parent of the inaugural of the title of NER?	Paulo_Muwanga	title	inaugural	father
where is the captain of the club that NER belongs to born?	2010_FIFA_World_Cup_squads	club	coach	currentclub
what is the division of people or things with the same name as NER?	USS_Manderson_Victory_(AK-230)	ship_namesake	subdivision_type
who is the tenant of the predecessor of the stadium that NER takes place?	2009_end-of-year_rugby_union_internationals	stadium	before	tenants
what is northwest of NER County	Burgess_Hill	shire_county	northwest
where are the heirs of The father of NER	Trin_Kiem	
what war did NER's namesake take part in?	German_destroyer_molders	ship_namesake	battles
who is the predecessor of Election after NER	California_gubernatorial_election,_1857	after_election	predecessor
Japanese nobleman (1536-1612) who was the successor of NER's father	Kondagaon	
where is the iconic location of the same name of NER	French_ship_Polyphemus_(1815)	ship_namesake	subdivision_type
what are the sponsors of the car race NER in Daytona, USA?	24_Hours_of_Daytona	sponsor	products
what is the timezong of the south of the southeast of NER?	Morgan,_U.T	southeast	south	timezone
what is the subdivision type of the people, things and things with the same name as NER?	HMCS_Kamloops	ship_namesake	subdivision_type
who is the leader of the Life of Place of the World Day of NER	2016_NBA_Summer_League	place	before
what is the deathpalce of the eponym of NER?	Haldane_(lunar_crater)	eponym	education
who is the leader of the NER's ship name	Type_626_tanker	ship_namesake	leader_name
what is the title of the father of NER?	Beatrice_I,_Countess_of_Burgundy	last	before
who is the leader of the Nationality life of NER	Vanek_(surname)	region	legislature	leader
what time zone uses the southwest of The stadium where the NER took place	SV_Transvaal	stadium	southwest	timezone_dst
who is the wife of The father of NER	Gyeongjong_of_Goryeo	
what is the name of the administrative district of the southwest of NER location	Sakura-Con	location	southwest	subdivision_name
who is the descendant of NER?	Ferdinand_Philippe,_Duke_of_Orleans	issue	after
where is the city of The operator of The stadium where the NER took place	2008–09_Coventry_City_FC_season	stadium	largest_city
what is the level of management in Northwest of NER	The_Soleras	nw	subdivision_type
where is the location in the east of the NER and which region is the location in the northwest?	Altamont,_UT	east	west	subdivision_name
what is the stadium that hosted the Events in NER	UEFA_Euro_2000_Final	event	stadium
what does the person and things that shares the same name with NER end up in?	HNoMS_Otra_(1939)	ship_namesake	event_end
what kind of company is the sponsor of NER?	Academy_Award_(radio)	sponsor	company_type
what is the type of the person and things that shares the same name with NER?	USS_Mazama_(AE-9)	ship_namesake
which state does the one that is after election of NER belong to?	United_States_Senate_election_in_South_Dakota,_2014	after_election
what are the subdivision ratings of the NER ship name	French_brig_Cygne_(1806)	ship_namesake	subdivision_ranks
what is the type of Alma mater of NER	Ed_Jackson_(Tennessee_politician)	alma_mater
NER, Wikimedia list article, what is the region of the location east of the city where it belongs	National_Register_of_Historic_Places_listings_in_Wasatch_County,_Utah	city	east	subdivision_name
who is the leader of the NER ship name	HMS_Nyasaland_(K587)	ship_namesake	leader
what is the title of the leader of NER	Spanish_general_election,_1869	leader	title
what is the affiliation that the alma mater of NER belongs to?	Joanne_Grant	alma_mater	affiliations
what is the level of people, things and things with the same name as NER?	French_ironclad_Courbet	ship_namesake	rank
the area covered by the Events in NER	Tanukhids	event	place
which party does the parliament hold for the seat held by NER belong to?	Democratic_Party_(Indonesia)	
which bay makes the eponym of NER famous?	Mach_(crater)	eponym	workplaces
how to address the children of NER?	Nurul_Izzah_Anwar	parents
who do the job after the one that is after election of NER (a presidential election in finland)?	Finnish_presidential_election,_1994	after_election	after
what classification level do people, things and things with the same name as NER belong to?	USCGC_Salvia_(WLB-400)	ship_namesake
which rank does the person and things that shares the same name with NER belong to?	USS_Accentor_(AMc-36)	ship_namesake	subdivision_ranks
what is the genre of the sponsor of NER	Unforgiven_(2003)	sponsor
in which league The operator of The stadium where the NER took place will play?	2014–15_Olympiacos_FC_season	stadium	established_event	government_type
which language does the lyrics of the title of NER use?	Hero_(Super_Junior_album)	title	music	language
what type of creators are NER	Identity_(Zee_album)	chronology	genre
where NER's election winner takes office	Democratic_Party_(HK)_leadership_election,_2002	after_election
where is the mayor of NER	Canton_of_Domart-en-Ponthieu	chieftown
which division does the administrative center of the birthplace of NER belong to?	River_Inny_(Leinster)	source1_location	subdivision_type
what is the instrument that the author of NER plays?	Gone_Girl_(soundtrack)	chronology	instrument
which place is called as the subdivision of the northeast of the stadium that NER takes place?	1998_Seattle_Seahawks_season	stadium	north	subdivision_type
what is the time zone used by North West NER's location	2017_Lamar_Hunt_US_Open_Cup_qualifying	location	northwest	timezone_dst
who is earlier than the one that is after election of NER	South_African_general_election,_1977	after_election	before
The head of NER who are the current incumbents	Community_of_Saint_Anselm	leader	incumbent
where is the birthplace of the people, things and things with the same name as NER?	President_El_Hadj_Omar_Bongo_(ship,_1978)	ship_namesake	title
where does the one that is after election of NER belong to?	French_legislative_election,_1914	after_election	title
what is the name of the administrative district of Area covered by the Parent of NER	Pogorze_Bukowskie	parent	seat	subdivision_name
who has an important influence on NER's eponymous	Protagoras_(crater)	eponym	influences
NER's location what area is the northern location in?	Business_routes_of_Interstate_15	location	north	subdivision_name
who are the producers of products related to the smartphone model NER	Xiaomi_Redmi_3	related	memory_card
in which city is the operator of the venue of NER?	1999-2000_FA_Cup	stadium	operator	city
what war did the first person with the title of NER fight in?	Curtis_LeMay	title	first
who is the heir of Election after NER	Philippine_presidential_election,_1953	after_election	successor
what are the iconic places for people, things and things with the same name as NER?	French_ship_Polyphemus_(1815)	ship_namesake	subdivision_type
what is the subdivision type of the southeast of the city that NER lives in?	San_Pitch_Mountains	city	southeast	subdivision_type
who is the successor of the predecessor of the descendant of NER?	Adad-nirari_III	issue	before	successor
who married the person and things that shares the same name with NER?	HMS_Osiris_(N67)	ship_namesake	consort
who is the head of the The main organ of the heads of NER	Party_leaders_of_the_United_States_Senate	body	leader
Wikimedia lists the location of the article NER which division does the location in the southwest belong to	List_of_Delta_Sigma_Theta_chapters	location	southwest	subdivision_type
where is the state of the NER election winner	Hawaii's_1st_congressional_district_special_election,_2010	after_election
what is the zoning of the location in the northwest of the city where NER is located?	National_Register_of_Historic_Places_listings_in_Los_Angeles_County,_California	city	northwest	subdivision_type
NER's location what division does the location in the west belong to?	Bannered_roads_of_US_Route_40	location	west	subdivision_type
where is the constituency of Election after NER	Hong_Kong_Island_by-election,_2000	after_election	honorific_suffix
which label does the location country of NER have?	HK_MK_Bled	league
which party does the one that is after election of NER belong to?	Israeli_legislative_election,_1981	after_election	party
what does the captain of the club that NER belongs to work for?	2015_FIFA_U-17_World_Cup_squads	club	coach	currentclub
who is the successor of the one that is after election of NER?	German_federal_election,_1920	after_election	after
what are the offspring of NER's parents	Neleus	parents	children
which party belongs to NER ship name	USCGC_Duane	ship_namesake	title
what time zone uses NER ship name	HMCS_Sherbrooke	ship_namesake	timezone_dst
what time zone does NER's Northwest location belong to?	Mieres,_Girona	nw	n
where the alma mater of Election is after NER	Peruvian_general_election,_1985	after_election
what is the timezong of NER's southern region?	Vilallonga_de_Ter	s	subdivision_type
who is the spouse of the people, things and things with the same name as NER?	SS_Prinses_Astrid	ship_namesake	succession
where is the southern region of NER?	Vallfogona_of_Ripolles	s	subdivision_name
what is the title of the predecessor of the candidate of NER?	United_States_House_of_Representatives_elections_in_Louisiana,_2014	candidate	before	title
NER, British politician (born 1967), what party is its leader	Michael_Ellis_(British_politician)	leader	party
what type of creators are NER	Ragga_Bomb	chronology
what is the name of the administrative division of The North of NER Millionaires	National_Register_of_Historic_Places_listings_in_Weld_County,_Colorado	city	northwest	subdivision_name
what is establishedEvent in NER country	2014_Gulf_Cup_of_Nations	stadium	before
where is the place where the person whose name was used to name the NER died	Dewar_(crater)	eponym	death_place
what Musical Instrument NER Timeline Did He Use	Stormy_Weather_(Lena_Horne_album)	chronology
what is the profession of Captain of the club of NER	France_national_under-21_football_team	club	league
NER, the season of a football team, where is the city of the operator of its venue	2012–13_Aris_Thessaloniki_FC_season	stadium	tenants	ground
what is the occupation of the founder of the team that NER belongs to?	Giancarlo_Fisichella	team	after	title
what is the administrative district of the person, thing, and thing with the same name as NER?	Vaygach_(1989_icebreaker)	ship_namesake	country_admin_divisions
what is the name of the administrative district of the southwest of NER location	List_of_Sigma_Pi_chapters	location	southwest	subdivision_name
what instruments did the creators of NER use	Parachilna_(album)	chronology
what is the famous eponymous work of NER	Levi-Civita_(crater)	eponym
what are the important positions of Election after NER	Central_Tibetan_Administration_general_election,_2016	after_election	office
what area does the administrative center of the birthplace of NER belong to?	River_Inny_(Leinster)	source1_location	subdivision_name	subdivision_name
where is the location of the NER vessel name	USS_Mazama_(AE-9)	ship_namesake
what is the religion of the people, things, things that have the same name as NER, a French destroyer	French_destroyer_Tonkinois	ship_namesake
what is the label of L'addition de NER	Ollusion	extra	label
what time zone uses NER's Eastern Site, Intercollegiate Basketball Season?	2016-17_Washington_State_Cougars_women's_basketball_team	home	north
To which series does the L'avant Predecessor of NER	Samsung_Galaxy_S5	related	series
who is the predecessor of the one that is after election of NER	United_States_Senate_election_in_Wyoming,_2000	after_election	predecessor
what are the related products (works) of NER related to	HTC_Desire_816	related	related
who founded the record company that issued NER?	Destination_Games	founders
who are the descendants of The name of the ship of NER	Victor_Emmanuel_II_of_Italy	issue
what does a lyricist with the title of NER do?	The_Beat_Goes_On_(Super_Junior_D&E_album)	title	genre
who is the predecessor of the incumbent of the title of NER?	Zhu_De	title	last	after
what classification level does the same name of NER belong to?	USS_Turkey_(AMS-56)	ship_namesake	subdivision_ranks
where died The mother of Children of NER	Amenhotep_III	children	mother	death_place
which manager leads the tenants of NER's venue	2014–15_Charlton_Athletic_FC_season	stadium	tenants	manager
who is issued by the person and things that shares the same name with NER?	Princess_Selandia	ship_namesake	issue
which division does the location in the northwest of NER's home ground belong to?	2013-14_Cal_State_Northridge_Matadors_women's_basketball_team	home	northwest	subdivision_type
to whom the person or thing with the same name as NER owes allegiance	ORP_General_Tadeusz_Kosciuszko	ship_namesake	allegiance
which club does the captain of the club that NER belongs to belong to?	Japan_national_football_team	club	coach	currentclub
who is the predecessor of the successor of the descendant of NER?	Hemma	issue	before	after
NER where is the city of the operator of its venue	2014–15_Accrington_Stanley_FC_season	stadium	operator	city
where is the operator of the venue of NER?	2014–15_AEL_Kalloni_FC_season	stadium	location
who the parents of NER's ship name are	French_Frigate_Artemise_(1829)	ship_namesake	parents
who was influenced by the person whose name was used to name NER?	Sherrington_(crater)	eponym	influenced
what occupation is the source of the NER name?	Tikhonravov_(crater)	eponym
NER's location what area is the northern city in?	2012-13_Real_Madrid_CF_season	location	n	subdivision_name
what is the subdivisionRanks of The name of the vessel of NER	USS_Toucan_(AM-387)	ship_namesake	subdivision_ranks
which party belongs to Election after NER	United_States_presidential_election_in_Wisconsin,_1880	after_election
what is the type of the person and things that shares the same name with NER?	USCGC_Pontchartrain_(1928)	ship_namesake	type
what is the management level of South East NER location	List_of_Lambda_Chi_Alpha_chapters	location	east	subdivision_type
who is the one that is after election of NER?	Italian_general_election,_1874	after_election	title
where do NER candidates' predecessors take office?	Results_of_the_Australian_federal_election,_2016_(New_South_Wales)	candidate	predecessor	alma_mater
what is the subdivisionRanks of The name of the vessel of NER	USS_Rattlesnake_(1813)	ship_namesake	format
NER consul and governor, where did his predecessor of the previous generation die	Titus_Pomponius_Proculus_Vitrasius_Pollio	before	predecessor	death_place
what is the subdivision rank of the people, things and things with the same name as NER (a barku) den estadonan uni di merka?	USS_Turkey_(AMS-56)	ship_namesake	subdivision_ranks
what is originated from the people, things and things with the same name as NER?	HMS_Osiris_(N67)	ship_namesake	children
what time zone is used for the location in the south of the city where the Wikimedia list article NER is located	National_Register_of_Historic_Places_listings_in_Sanpete_County,_Utah	city	south	timezone
what is the subdivisionRanks of The name of the vessel of NER	French_destroyer_Albatros	ship_namesake
what is the timezong of the city in the south of NER	Sant_Esteve_de_la_Sarga	s	n	s
NER, British politician (born 1943), what is the predecessor of the current incumbent of his title	Margaret_Beckett	title	incumbent	office
which type of subdivision does NER's southern region belong to?	Castellnou_de_Bages	s
in which league The operator of The stadium where the NER took place will play	2012–13_Luton_Town_FC_season	stadium	southwest	constituency_westminster
where is the heir of The descendant of NER	Grand_Duke_Vladimir_Kirillovich_of_Russia	issue	successor
what is related to responsible for NER	Super_Bowl_LI_halftime_show	sponsor	related
what are the regions of NER-related events in isolated human groups	Tanukhids	event	partof
what is the map caption of the people, things and things with the same name as NER (a barku)?	USS_Neponset_(ID-3581)	ship_namesake	basin_countries
what awards NER's Candidate forward has won	Constitution_election_results_in_the_United_Kingdom_general_election,_1922	candidate	before
what is the country of the caption of the photo of The stadium where the NER took place	2009-10_LV_Cup	stadium	before	after
who is the successor of the previous generation of the successor of NER?	Philip_Haddon-Cave	after	before	predecessor
what is the successor to The Descendant of NER	Berengaria_of_Castile	issue	successor
what is the subdivision name of the city in the south of NER spain?	Lliça_de_Vall	s	n
what are the subdivision ratings of the NER ship name	French_brig_Amarante_(1793)	ship_namesake	subdivision_ranks
where is the one that is after election of NER born?	Peruvian_general_election,_1985	after_election
which place is called as the subdivision of the east of the parent of NER?	Pogorze_Bukowskie	parent	seat	subdivision_name
what type of NER Timeline	The_Milt_Jackson_Big_4	chronology
who is the next the cause of NER	Battle_of_Huoyi	result	succession
NER where is the address of the tenant of its venue	2012_Mito_HollyHock_season	stadium	tenants	ground
which field does the origin of NER's name work in?	Harden_(crater)	eponym	field
who rules the father of NER?	kinga_goncz	
where is the alma mater of the predecessor of the candidate of NER?	Results_of_the_Australian_federal_election,_2016_(Victoria)	candidate	predecessor	alma_mater
which label does NER related events belong to?	UEFA_Women's_Euro_2013_Final	event	label
what descendants did the father of the Empress of Japan (680-748) NER have	Emperor_Kobun	
which state does the alma mater of NER activist, belong to?	Joanne_Grant	alma_mater	state
what zip code is the same name for NER?	HMCS_Sherbrooke	ship_namesake	postal_code_type
where did the origin of NER's name die?	Erlanger_(crater)	eponym	death_place
what is the subdivision name of the city in the south of NER?	That,_Catalonia	s	n	subdivision_name
what is the occupation of the creator of NER	Ragga_Bomb	chronology
who is the female parent of the client of NER?	Royal_Spring,_Warsaw	client	issue
what type of school is NER's alma mater?	Mark_Van_Ameyde	alma_mater
what is the next term of The winner of NER	Henry_I,_Duke_of_Brabant	as
which battle does the people, things and things with the same name as NER take part in?	USNS_Lewis_B_Puller_(T-ESB-3)	ship_namesake	battles
what is the time zone of the southern city of NER	Sant_Fost_de_Campsentelles	s	timezone
what is the subdivisionRanks of The name of the vessel of NER	HMS_Sparrow_(1828)	ship_namesake
who is earlier than the leader of NER	Michael_Ellis_(British_politician)	leader	before
where is the constituency of the Northern NER location	2015–16_West_Bromwich_Albion_FC_season	location	east
who leads the northwest of the location of NER?	Hong_Kong_national_football_team_results_(1980–89)	location	northwest	leader_name
what takes the place of the people, things and things with the same name as NER	Spanish_cruiser_Emperador_Carlos_V	ship_namesake	succession
where is the region of The name of the ship from NER	USS_Platte_(AO-186)	ship_namesake
what is the office of the leader of the label of NER?	Hong_Kong_legislative_election,_2016	label	leader1_name	office
what language do singers who perform for NER use	Tokyo_Juliet_(TV_series)	extra	type_of_music
what is the description of the map of NER's ship name	USS_Cimarron_(AO-177)	ship_namesake
what is the famous work of NER's eponymous	Mach_(crater)	eponym	workplaces
where the alma mater of NER's ship name is	USRC_McLane_(1832)	ship_namesake	title
what is the famous work of the person named NER?	Shoemaker_(lunar_crater)	eponym
where is the place where the person, thing, and thing with the same name as the schooner and the Spanish training ship NER died?	Spanish_ship_Juan_Sebastian_Elcano	ship_namesake	death_place
what is the title of the one that is after election of NER?	Italian_presidential_election,_1978	after_election	title
who does the people, things and things with the same name as NER work for?	ORP_General_Tadeusz_Kosciuszko	ship_namesake	allegiance
which league does the operator of NER's venue play for?	2013-14_AEL_Kalloni_FC_season	stadium	tenants	league
who is the predecessor of NER's election winner?	German_presidential_election,_1994	after_election	predecessor
which one is known as the prime minister of the other name of the candidate of NER?	Portsmouth_North_(UK_Parliament_constituency)	candidate	namedata	primeminister
where is the operator of the stadium that NER takes place located?	2009–10_Olympiacos_FC_season	stadium	w	s
what is the famous work of NER's eponymous	Maclaurin_(crater)	eponym	workplaces
what is the largest city with people, things and things that have the same name as NER?	Brazilian_monitor_Ceara	ship_namesake	largest_city
who is NER's father's successor?	Yelu_Aburi	father
what is the logo of NER's label	Xiao_He	
what is the name of the administrative division of Southern NER	Llica_d'Amunt	s	s
where is the alma mater of NER located?	James_Boyd_Hawkins	alma_mater	filetype
what the job of the Founders of the NER team is	Giancarlo_Fisichella	team	after
who is the predecessor of Election after NER	Israeli_Labor_Party	leader1_name	title
which house does the person and things that shares the same name with NER belong to?	SMS_Kaiser_Friedrich_III	ship_namesake	house
what the last work of NER's The Name of the Ship was?	Wet_Nellie	ship_namesake	studio
who are the affiliates of Alma mater de NER	Patricia_Clavin	alma_mater	affiliations
who is the first predecessor of the title of NER?	Margaret_Beckett	title	inaugural	after
what is the next term of the Parents of NER	USS_Franklin_(1795)	ship_namesake	successor
where is the captain of the club that NER belongs to born?	UEFA_Euro_2012_squads	club	coach	currentclub
what time zone uses West of Southeastern NER utah, united states?	Levan,_UT	southeast	west	timezone_dst
who is the predecessor of The leader of NER	Mongolian_legislative_election,_2016	leader	predecessor
who is the commander of the people, things and things with the same name as NER?	French_ship_Rivoli_(1810)	ship_namesake	commander
who is the predecessor of NER's election winner?	Japanese_general_election,_1892	after_election	predecessor
which rank does the people, things and things with the same name as NER belong to?	USS_Toucan_(AM-387)	ship_namesake	subdivision_ranks
what is the title of The Father of NER	Empress_Dowager_Cixi	house	ethnicity
who will be the next Election after NER	Spanish_general_election,_1931	after_election	before
what is the country of birth of the captain of the club that NER belongs to?	UEFA_Euro_2012_squads	club	coach	currentclub
which state does the alma mater of NER belong to?	Javanese_language	
where is the city of The operator of The stadium where the NER took place	2009–10_Olympiacos_FC_season	stadium	n	n
who is the successor of the person and things that shares the same name with NER	RMS_Queen_Mary_2	ship_namesake	issue
who is the predecessor of Election after NER	French_legislative_election,_1893	after_election	title
what region does NER's province belong to in the country?	Hanaoka_mine	state/province	region
who is the tenant of the successor of NER's venue?	2011_K_League_Championship	stadium	tenants	after
where is the mayor of NER	Canton_of_Aubenton	chieftown	east
who are the affiliates of Alma mater de NER	Amy_Jephta	alma_mater	affiliations
what musical instrument did NER's name use?	List_of_awards_and_nominations_received_by_Jessica_Simpson	name	instrument
what is the University of NER Title Writer?	List_of_Star_Trek:_Deep_Space_Nine_episodes	title	story
who is the successor of the people, things and things with the same name as NER?	RMS_Queen_Mary_2	ship_namesake	issue
which religion does the country that is affected by NER believe?	2006_Yogyakarta_earthquake	countries_affected	subdivision_type
what event determined the establishment of the venue for the NER national team	Dingboche	subdivision_type
who is the leader of the Northern Place of NER	2008_Davis_Cup_Americas_Zone_Group_I	venue	north	leader_title
who is the predecessors of Election after NER	United_States_Senate_election_in_Rhode_Island,_2012	after_election	predecessor
who is the predecessors of The leader of NER	United_States_of_Indonesia	leader	predecessor
what is the war in which people, things, and things with the same name as NER participated?	Russian_destroyer_Marshal_Shaposhnikov	ship_namesake	battles
what is the club in which Captain of NER's club works	2015_UEFA_European_Under-19_Championship_squads	club	coach	clubs
where is the person who was used to name the lake ner on titan	Jingpo_Lacus	eponym	location
who is the father of the person, thing, thing with the same name as NER?	SMS_Erzherzog_Ferdinand_Max_(1865)	ship_namesake	succession
what is the type of business of NER manager	Hisense_4K_TV_300	sponsor
who is the predecessor of Election after NER	United_States_Senate_election_in_West_Virginia,_2014	after_election	predecessor
what time zone uses Club in which NER location is part	2013-14_Catalan_Cup	location	n	timezone1_dst
which timezone does the northwest of NER belong to?	Calafell	nw	nw
A town in Sampitt County, Utah, USA, what is the area of NER, the location in the south, and the location in the northwest?	Wales,_Utah	southeast	west	subdivision_name
which dynasty does the legislature of the nationality of NER belong to?	Vanek_(surname)	nationality	legislature	house
who do the job after the one that is after election of NER	United_States_Senate_election_in_Wyoming,_2000	after_election	successor
what is the iconic location of NER's namesake	French_ship_Polyphemus_(1815)	ship_namesake	subdivision_type
which office does the one that is after election of NER belong to?	South_African_general_election,_1966	after_election	honorific_prefix
NER's election winner whose last term was	Kiribati_presidential_election,_2012	after_election	title
who is the successor of the successor of NER?	Berengaria_of_Castile	issue	after
where is the address of The operator of The stadium where the NER took place	2014–15_Panathinaikos_FC_season	stadium	n	n
what is the label of the area where NER is used?	Zengovarkony	subdivision_type
what does NER related things have to do with	HTC_Desire_626	related	related
what is the timezong of the northeast of the city that NER lives in?	National_Register_of_Historic_Places_listings_in_Horry_County,_South_Carolina	city	northeast	subdivision_type
who is the operator of NER's famous work?	Chesley,_Dawn	
what type of subject is NER	The_Wizarding_World_of_Harry_Potter_(Universal_Studios_Japan)	theme	genre
what is the management level of Northwest of NER	The_Tower_of_Espanol	nw
what is the area of the location south of NER?	font-rubi	s	subdivision_name
what is the famous work of NER's eponymous	Stokes_(Martian_crater)	eponym	before
where does the person and things that shares the same name with NER take place?	French_destroyer_Valmy	ship_namesake	place
who is the successor of the people, things and things with the same name as NER?	King_George_(1785_ship)	ship_namesake	issue
where is the address of The operator of The stadium where the NER took place	2016_Buriram_United_FC_season	stadium	operator	ground
what is the type of Alma mater of NER	Royal_Flora_Ratchaphruek	city	blank_info
what is the subdivision type of the northeast of the southeast of NER utah, united states?	Meadow,_U.T	southeast	northeast	subdivision_type
which league does the operator of the stadium that NER takes place belong to?	2008–09_Everton_FC_season	stadium	southwest	constituency_westminster
what is the specialty of Election after NER	United_Malaysia_National_Organization_leadership_election,_1972	after_election	honorific_suffix
In what condition is NER's Alma mater	Edward_McAlexander	alma_mater	state
who is the President of Election after NER	Israeli_Labor_Party	leader1_name	title
which party belongs to Election after NER	Estonian_election_election,_2003	after_election
what is the successor of the writer of NER?	On_ne_change_pas	extra	occupation
which battle does the person and things that shares the same name with NER take part in?	USS_Bainbridge_(DDG-96)	ship_namesake	battles
what is the religion of the leaders of NER?	Al-Muthanna_governorate_election,_2013	leader	honorific_prefix
who did a job before the one that is after election of NER?	Election_Committee_(Legislative_Council_constituency)_by-election,_2001	after_election	district
what time zone does the person or thing with the same name as NER belong to	HMCS_Woodstock	ship_namesake	subdivision_type
who is the leader of the legislature of the residence of NER?	One_Life_to_Live_characters_(1968–79)	residence	legislature	leader
who is the candidate for the title of NER now?	Constitution_election_results_in_the_United_Kingdom_general_election,_1923	candidate	after	title
what is the profession of The name of the vessel of NER	USS_Susan_B_Anthony_(AP-72)	ship_namesake
where NER's The Name of the Ship takes place?	French_ship_Rivoli_(1810)	ship_namesake	place
who is the successor played by the Hong Kong politician NER?	Steven_Poon	alongside	appointed
from what era came the Founders of the NER team	Heikki_Kovalainen	years	before
where is the title of The front of The stadium where the NER took place	2013_Chinese_FA_Cup	stadium	before	title
who is the heir of Election after NER	Danish_general_election,_2007	after_election	title
where does The Person Affecting NER work?	Siaka_Stevens	honorific_suffix
who are the founders of Le label de NER	Destination_Games	founders
which type of subdivision does the southwest of the source location of NER belong to?	River_Inny_(Leinster)	source1_location	subdivision_type
where is the location of the home to NER located?	2012-13_Saint_Louis_Billikens_men's_basketball_team	home	location	city
what are the descendants of the person or thing with the same name as NER?	French_frigate_Cleopatra_(1781)	ship_namesake	issue
which network does the author of NER belong to?	It's_a_SpongeBob_Christmas!_albums	chronology	network
what country was the captain of the NER club location born in?	1999_FIFA_World_Youth_Championship_squads	club	manager
what is the timezong of the northeast of the stadium that NER takes place?	1986_Seattle_Seahawks_season	stadium	northwest	postal_code_type
where does the person and things that shares the same name with NER occur?	USS_Philippine_Sea_(CG-58)	ship_namesake
who is the predecessor of NER's election winner?	Italian_general_election,_1992	after_election	predecessor
where is the location of the Northeast NER location	2012_Tianjin_Teda_FC_season	location	northwest	location
which club does the captain of the successor of NER belong to currently?	Valerie_Adams	after	before
which timezone does the person and things that shares the same name with NER belong to?	HMCS_Amherst	ship_namesake	timezone
what dynasty does NER User's Life belong to?	20×138mmB	used_by	legislature	house
what is the author of NER?	Stormy_Weather_(Lena_Horne_album)	chronology
who is the owner of the successor of the stadium that NER takes place?	2003-04_UEFA_Champions_League_group_stage	stadium	after	owner
in which area is the southern location of the NER held?	Football_at_the_2016_Pekan_Olahraga_Nasional	stadium	south	subdivision_name
where is the title of Election after NER	Northern_Cyprus_presidential_election,_2015	after_election
which league does the operator of NER's venue play for?	Czech_Republic_national_football_team_results	stadium	tenants	league
which place is called as the subdivision of the northwest of NER?	Tremp	nw
where is the Alma Mater of Election after NER	Tunisian_Constituent_Assembly_election,_2011	after_election	title
what is a related product (work) related to NER	Overhand_knot	related
who is the successor of NER's election winner?	United_States_Senate_election_in_Vermont,_1980	after_election	successor
what is the party of the person, thing, and thing with the same name as the gear-class destroyer NER?	USS_Joseph_P_Kennedy_Jr_(DD-850)	ship_namesake	party
what time zone is used in the southern cities of NER	Montgai	s	w
what is the subdivision name of the northeast of the home to NER?	2015-16_Colorado_State_Rams_women's_basketball_team	home	northeast	subdivision_name
who has an important influence on the person and things that shares the same name with NER?	French_frigate_Descartes	ship_namesake	influences
which league does the operator of the stadium that NER takes place belong to?	2015–16_Olympiacos_FC_season	stadium	established_event	type
in which league The operator of The stadium where the NER took place will play	2011–12_Ipswich_Town_FC_season	stadium	before	after
which rank does the people, things and things with the same name as NER belong to?	HMS_Woodpecker_(U08)	ship_namesake	image_caption
what titles do NER's candidate successors hold?	Constitution_election_results_in_the_United_Kingdom_general_election,_1923	candidate	title	incumbent
who are the descendants of NER-related events?	Gurjara-Pratihara	event	issue
which timezone does the city in the south of NER belong to?	Sant_Fost_de_Campsentelles	s	timezone1_dst
who is the successor of the successor of the place where NER is held?	2010_FIFA_World_Cup_qualifying_–_AFC_Third_Round	stadium	after	after
what is the subdivision type of the south of the home to NER	2014-15_Portland_State_Vikings_women's_basketball_team	home	south	subdivision_type
what the Legislature is in NER's Home Country	Donje_Svarce	subdivision_type
what is the title of the predecessor of the descendant of NER?	Sigebert_III	issue	before	title
where is the city of Alma mater from NER	AJ_Petrucci	alma_mater
in which city is the operator of the venue of NER?	2014–15_Panathinaikos_FC_season	stadium	n	n
which rank does the people, things and things with the same name as NER belong to?	French_destroyer_Albatros	ship_namesake
Wikimedia listing article which team does the captain of the NER club location play for?	1999_FIFA_World_Youth_Championship_squads	club	manager
where is the operator of the stadium that NER takes place located?	1967–68_EU_Lleida_season	stadium	tenants
who is the predecessor of Busy people of NER title	Mohammad_Mohammadullah	title	first	predecessor
what is the subdivision type of the southwest of the location of NER	2015–16_PFC_CSKA_Sofia_season	location	southwest	subdivision_type
what is the fame of the person whose name was used to name NER?	Maclaurin_(crater)	eponym	workplaces
where is the location of the NER vessel name	HMCS_Bras_d'Or_(FHE_400)	ship_namesake
what is the origin of NER's name known for?	Fabry_(crater)	eponym	known_for
what classification level does the person or thing with the same name as NER belong to?	Belgian_minehunter_Narcis_(M923)	ship_namesake
what is the level of management at The name of the ship of NER	Scarborough,_Toronto	shire_county	status
which type does the southwest of the address of NER belong to?	Pim_Fortuyn	death_place	subdivision_type
who is the mother of the person and things that shares the same name with NER?	RMS_Queen_Mary_2	ship_namesake	issue
what is the Homeland of Captain of The NER Club	1999_FIFA_World_Youth_Championship_squads	name
what are the subdivision ratings of the NER ship name	Belgian_minehunter_Primula_(M924)	ship_namesake
which battle does the people, things and things with the same name as NER take part in?	HMCS_Carleton	ship_namesake	before
who is the predecessor of the one that is after election of NER?	French_legislative_election,_1914	after_election	predecessor
who is the successor of the person or thing related to the result of NER	Henry_I,_Duke_of_Brabant	as
who is the creator of the car that NER is related to?	1990_DFB-Supercup	stadium
what branch NER's ship name belongs to?	HMS_General_Wolfe_(1915)	ship_namesake	branch
which house does the last of the descendant of NER belong to?	Juan_Carlos_I_of_Spain	issue	before	house
what war did the person or thing with the same name as NER participate in?	USNS_Lewis_B_Puller_(T-ESB-3)	ship_namesake	battles
what is the level of management at NER's South Site	2011-12_Utah_State_Aggies_men's_basketball_team	home	southeast	subdivision_type
which division does a person, thing, or thing with the same name as NER belong to?	SMS_Zenta	ship_namesake	subdivision_type
which national team does the captain of the club that NER belongs to belong to?	2005_FIFA_World_Youth_Championship_squads	club	before	name
what is the author of NER?	Horror_of_Glam_Rock	chronology	profession
what includes the people, things and things with the same name as NER?	French_destroyer_Verdun	ship_namesake	partof
who is the male parent of the person and things that shares the same name with NER?	Scottish_warship_Margaret	ship_namesake	father
who is the leader of the Northern NER location	2016_Canada_Open_Grand_Prix	location	north	subdivision_name
what is the predecessor of NER's election winner?	Italian_general_election,_1874	after_election	title
what important positions Election has after NER	Civic_Democratic_Party_leadership_election,_1997	after_election	title
what era did the eponym of NER come from	Lippershey_(crater)	eponym
who is the heir of Election after NER	Bulgarian_Constitutional_Assembly_election,_1946	after_election	successor
NER, U.S. citizen residing outside the U.S., to which party the legislature of the region to which they belong	American_diaspora	region	northwest	subdivision_type
what is related to NER's ship name	USS_Somali_(DE-111)	ship_namesake	related
NER, Anwar, who is the successor to the 2006 election winner	Connecticut_gubernatorial_election,_2006	after_election	candidate
who is before the cause of NER?	Henry_I,_Duke_of_Brabant	as
which battle does the person and things that shares the same name with NER take part in?	Russian_destroyer_Marshal_Shaposhnikov	ship_namesake	battles
which title does the northeast of the location of NER own?	2012_Guangzhou_Evergrande_FC_season	location	northeast	leader_title
which division does the administrative center of NER's location belong to?	2013–14_Videoton_FC_season	location	seat	subdivision_type
where is NER's Northwest location based?	Arrondissement_of_Amiens	town	subdivision_name
what are the countries of the event involved in NERparticipante	Empire_of_China_(1915–16)	event
town in Box Elder County, Utah, U.S.A., the location in the east of NER, the location in the south, and which division does the location belong to?	Howell,_UT	east	north	subdivision_type
what is NER's Customer Dynasty?	Royal_Spring,_Warsaw	client	issue
what is the alma mater of NER's election winner	Guatemalan_general_election,_2011	after_election	alma_mater
what is the origin of NER's namesake	HMCS_Ville_de_Quebec_(K242)	ship_namesake	settlement_type
who is the chairman of the tenant of NER's venue	1994_JEF_United_Ichihara_season	stadium	tenants	chairman
what is the region of the person or thing with the same name as NER?	USCGC_Snohomish_(WYTM-98)	ship_namesake	subdivision_type
what is the famous work of the person named NER?	D'Alembert_(crater)	eponym
what is the canton of the chief town of NER	Canton_of_Coucy-le-Château-Auffrique	chieftown
what is the subdivision type of the west of the south of NER utah, united states?	Spanish_Fork,_Utah	west	subdivision_type
what titles do Wallner's election winners hold?	United_States_Senate_election_in_North_Carolina,_1990	after_election	after
where is the constituency of Next to NER	Felix_Chung	alongside	honorific_suffix
who are the current holders of the Nominator of The title of NER	Laifour	
NER where is the capital of its province	Selkirk_mine	state/province	seat
who is the father of the leader of NER?	Spanish_general_election,_1869	leader	father
who will be the next Election after NER	Japanese_general_election,_1892	after_election	after
what is the fame of the person whose name was used to name NER?	Davy_(crater)	eponym	field
what the management level of The North of NER's place of death is	Paul_W_Airey	death_place	east	subdivision_type
who are the descendants of NER's ship name	Queen_Charlotte_(1812_ship)	ship_namesake	issue
which sport does the captain of the club that NER belongs to play?	2015_UEFA_European_Under-17_Championship_squads	club	coach	position
what are the products of the NER team	Thomas_Pages	team
who is the Prime Minister of Election after NER	Iranian_legislative_election,_1956	after_election	before
what is the college of the coach of NER?	Russia_women's_national_volleyball_team	coach
what does the namesake of NER have to do with	Chilean_brigantine_Araucano	ship_namesake	related
where is the title of Inaugural speech of The title of NER	Margaret_Beckett	title	seat	title
which house does the legislature of the user of NER belong to?	2K22_Tunguska	used_by	legislature	house
who is the head of the The main body of the heads of NER	Party_leaders_of_the_United_States_Senate	body	leader
what is the zoning of the location in the southeast of NER Utah, USA?	Meadow,_U.T	southeast	northeast	subdivision_type
where did the voters for the NER's election winner come from?	Hong_Kong_Island_by-election,_2000	after_election	honorific_suffix
what is the subdivisionRangs of The name of the ship of NER, un french lead ship of chacal-classes?	French_destroyer_Chacal	ship_namesake	image_caption
what is the Homeland of Captain of The NER Club	UEFA_Euro_2016_squads	name
who is the successor of the person or thing related to the result of the battle NER?	Bagrat_I_of_Iberia	
where the arrondissement of La ville principal de NER is located?	Canton_of_Tremblay-en-France	chieftown	canton
what is the timezong of the northeast of the place that NER takes place?	2016_WNBA_Playoffs	place	southeast	timezone
what is the title of the consort of the ruler of NER	Hatice_Muazzez_Sultan	regent	issue
what the battle of NER's ship's name is	German_destroyer_molders	ship_namesake	battles
which genre does the author of NER belong to?	They_All_Went_to_Mexico	chronology	genre
which timezone does the east of the northeast of NER belong to?	Sarral,_Tarragona	northeast	east	timezone
what is the language that is commonly used by the combatant of NER?	List_of_mayors_of_Chiayi	
who is the predecessor of Inaugural speech of The title of NER	Brian_Cowen	title	inaugural	predecessor
who owns the music of the car that NER is related to?	1990_DFB-Supercup	stadium
who are the leaders of NER	Michael_Ellis_(British_politician)	leader	after
what is the nationality of Explanation of The Dynasty of NER	Ladislaus_of_Naples	father	house	nationality
who is the leader of the Northwest of The stadium where the NER took place	Uzbekistan_national_under-23_football_team_results	stadium	established_event	leader
what titles do NER's election winners hold?	United_States_Senate_election_in_West_Virginia,_2014	after_election	title
who is the predecessor of the cause of NER?	Bagrat_I_of_Iberia	
which eponymous area of NER belongs to	Schliemann_(crater)	eponym	field
what are the important positions held by NER ship name	USS_Nitze	ship_namesake	title
what is the title of The father of NER	Kondagaon	
what is the management level of West of South East of NER	Holden,_U.T	southeast	west	subdivision_type
what is the traditional form of the The operator of The stage where the NER took place	2014_CAF_Champions_League_qualifying_rounds	stadium	tenants	ground
what party is the legislature of NER's nationality?	Vanek_(surname)	region	legislature	party
what is the level of management in Le sud de NER, un commune in catalonia, spain?	Lliça_de_Vall	s	n
which battle does the person and things that shares the same name with NER take part in?	SS_Abner_Doubleday	ship_namesake	battles
what is the operator of the stadium that NER takes place named?	2014_CAF_Champions_League_qualifying_rounds	stadium	tenants	ground
which team does the captain of the NER club location play for?	2009_FIFA_U-20_World_Cup_squads	club	coach	currentclub
what is the subdivision name of the west of the location of NER?	Okanagan_International_Marathon	location	west	subdivision_name
which house does the people, things and things with the same name as NER belong to?	RMS_Queen_Mary_2	ship_namesake	issue
which one is known as the prime minister of the one that is after election of NER	Angolan_legislative_election,_2012	after_election	primeminister
NER who is the author of its themes	Planet_Snoopy	theme	syndicate
which division does the location in the west of where NER died belong?	John_James_Joseph_Monaghan	death_place	west	subdivision_type
who is the predecessor of The front of Candidate of NER	Swiss_Council_of_States_elections,_2007	candidate	before	predecessor
what is the name of the administrative district of Western NER Millionaires	National_Register_of_Historic_Places_listings_in_Millard_County,_Utah	city	west	subdivision_name
where does the religion of The founder of The house of NER come from?	Norodom_Kanviman_Norleak_Tevi	house	founder	religion
where is the people, things and things with the same name as NER born?	MS_Giulio_Cesare	ship_namesake	death_place
which religion do the leaders of NER believe in?	Albanian_Kingdom_(1928–39)	leader	religion
who is the founder of the The name of the ship of NER	Japanese_cruiser_Takao_(1930)	ship_namesake	denomination
who is the descendant of the parent of NER	Paul-Philippe_Hohenzollern	parents
who leads the legislature of the region of NER?	Rocky_Mountains	region	legislature	leader
where is the city of Tenants of The stadium where the NER took place	2001_Sagan_Tosu_season	stadium	tenants	city
who leads the legislature of the region to which the NER belongs in the Highland Region of the South Central United States?	Ozarks	region	legislature	leader
where is the person or thing with the same name as NER	Spirit_of_Kangaroo_Island	ship_namesake	location
what is the job of the author of NER	Horror_of_Glam_Rock	chronology	profession
who is the successor of the client of NER?	Royal_Palace_of_Ficuzza	client	issue
which city does the alma mater of NER belong to?	Igor_Chubais	alma_mater
which timezone does the south of the location of NER belong to?	2011-12_in_Australian_soccer	location	south	timezone
who is the mother of the next generation of the consort of the queen of ancient Egypt NER's consort?	Tyti	issue	mother	spouse
where is the title of Election after NER	Manila_local_elections,_2016	after_election	title
where is the birthplace of NER's election winner	Kiribati_presidential_election,_2012	after_election	title
what is the subdivision type of the south of the city that NER lives in?	National_Register_of_Historic_Places_listings_in_Salt_Lake_County,_Utah	city	southeast	subdivision_type
NER, Wikimedia listing article, what is the national team the captain of its club location belongs to	2009_FIFA_U-17_World_Cup_squads	club	before	name
what is the subdivision type of the north of the home to NER?	2012-13_Utah_State_Aggies_men's_basketball_team	home	north	subdivision_type
NER, the American college basketball season, whose home legislature is led	2016-17_Valparaiso_Crusaders_men's_basketball_team	home	legislature	leader
which dynasty does NER's father belong to?	Prince_Regent	
where was the birthplace of the founder of the team of Finnish racing driver NER	Heikki_Kovalainen	after	before	after
what is the profession of Lyrics of The title of NER?	Hero_(Super_Junior_album)	title	genre
what is the timezong of the body of the title of NER	George_Wallace_Jr.	title	southwest
where NER's election winner takes office	Northern_Cyprus_presidential_election,_2015	after_election
NER, Wikimedia list article, what is the zoning of the location in the southern part of the autonomous region	List_of_historic_places_in_Westman_Region,_Manitoba	municipality	south	subdivision_type
where does the people, things and things with the same name as NER occur?	SMS_Novara_(1850)	ship_namesake	place
what the NER main town area is?	Canton_of_Saint-Nicolas-de-la-Grave	chieftown
which timezone does the east of the parent of NER belong to?	Pogorze_Bukowskie	parent	seat
where NER's The Name of the Ship takes place?	Italian_cruiser_Varese	ship_namesake	place
where did NER's eponymous religion come from?	Stokes_(Martian_crater)	eponym	workplaces
where the birthplace of the city is from Captain of The NER Club	UEFA_Euro_2016_squads	name
who leads the legislature of the locale of NER?	Montana_Rail_Link	locale	legislature	leader
who is the Prime Minister of Election after NER	United_Malaysia_National_Organization_leadership_election,_2009	after_election	honorific_suffix
where is the title of Election after NER	French_legislative_election,_1914	after_election	title
what time zone uses Northwest of NER	La_Vall_de_Bianya	nw	subdivision_type
who is the wife of NER's ship name	SS_Prinses_Astrid	ship_namesake	succession
what time zone uses South of NER location a theme park in bandar sunway, subang jaya, selangor, malaysia?	Sunway_Lagoon	location	east
which genre does the author of NER belong to?	Dirt_Sledding	chronology
who is the predecessor of Election after NER	Angolan_legislative_election,_2012	after_election	predecessor
what is the type of creator of NER	They_All_Went_to_Mexico	chronology	genre
which type of subdivision does the northwest of NER belong to?	The_Senia	nw	subdivision_type
who will be Election after NER next	United_States_Senate_election_in_Ohio,_1898	after_election	after
what is the area of the place in the northwest of NER	Pepingen	nw	n
which division does the administrative center of the birthplace of NER belong to?	River_Inny_(Leinster)	source1_location	subdivision_type
what is the name of the national capital of The name of the ship of NER	HMS_Ascension_(K502)	ship_namesake	country_capital_name
what is the map caption of the people, things and things with the same name as NER	USS_Neponset_(ID-3581)	ship_namesake	basin_countries
who is the founder of the sponsor of NER?	2011_Penrith_Panthers_season	sponsor
where are the heirs of The winner of NER	Henry_I,_Duke_of_Brabant	as
that before the person or thing related to the consequences caused by NER is?	Battle_of_Huoyi	result	succession
what is the subdivision rank of the person and things that shares the same name with NER?	USS_Torchwood_(AN-55)	ship_namesake	subdivision_ranks
where is the region of The province where the NER is located	Red_River_Delta_coalfield	state/province	north
what Election run agency is after NER	Romanian_general_election,_1922	after_election	predecessor
in which country is the Alma mater of NER	Wayne_Chabre	alma_mater	country
where NER's eponymous birthplace is	Eijkman_(crater)	eponym
where is the birthplace of Election after NER	Peruvian_general_election,_1985	after_election
who is the predecessor of The Children of the NER	Joseph_Chamberlain	children	predecessor
where is the operator of the stadium that NER takes place grounded?	2012-13_PAOK_FC_season	stadium	tenants	ground
what is the club in which the head coach of the NERworks	Seattle_Sounders_FC_2	s
which club does the captain of the club that NER belongs to belong to?	2015_FIFA_U-17_World_Cup_squads	club	coach	clubs
where is the origin of NER's name from?	Siddons_Patera	eponym	birthplace
what is the classification level of the same name for NER	USS_Gull_(AMS-16)	ship_namesake	subdivision_ranks
where does the religion of Election after NER	Ecuadorian_general_election,_2013	after_election	religion
what religion the Generals of the participating NERs believe in	Keith_Williams_(offensive_lineman)	college	location
which battle does the people, things and things with the same name as NER take part in?	German_destroyer_molders	ship_namesake	battles
what area is the NER's home east?	2015-16_South_Dakota_State_Jackrabbits_men's_basketball_team	home	west	subdivision_name
which instrument does the author of NER play?	Etta_James_(1973_album)	chronology
what are the descendants of NER's generals?	List_of_emperors_of_the_Han_dynasty	
what is the subdivision rank of the people, things and things with the same name as NER?	French_destroyer_Tigre	ship_namesake	subdivision_ranks
what is the canton of the chief town of NER	Canton_of_Villers-Cotterets	chieftown
what the job of NER's name is	List_of_awards_and_nominations_received_by_Bridgit_Mendler	name
in which league The operator of The stadium where the NER took place will play?	2013-14_Luton_Town_FC_season	stadium	southeast
what is the party of the legislature of the place that NER takes place?	2015-16_CB_Gran_Canaria_season	place	legislature	party
what is the time zone of the same name of the US Navy Schiphol van der NER	USS_Harpers_Ferry_(LSD-49)	ship_namesake	timezone_dst
in which state is the election winner for Wallner?	United_States_Senate_election_in_Kansas,_2014	after_election	state
who is the prime minister of the leader of NER	Michael_Ellis_(British_politician)	leader	primeminister
who is the father of NER's ship name	RV_Kronprins_Haakon	ship_namesake	father
what it the product of the sponsor of NER?	Hisense_4K_TV_300	sponsor
what time zone uses The Northeast of NER Millionaires	National_Register_of_Historic_Places_listings_in_Los_Angeles_County,_California	city	northwest	timezone_dst
who is the consort of the person and things that shares the same name with NER?	Egyptian_referendum,_1956	before_election	nationality
who operates the successor of the stadium that NER takes place?	2014-15_KNVB_Cup	stadium	after	owner
what is the famous eponymous work of NER	Cayley_(crater)	eponym	work_institution
what is the title of the descendant of the ruler of NER	Turhan_Hatice_Sultan	regent	issue
who is the heir to Election after NER	New_Zealand_Labor_Party_leadership_election,_1988	after_election	honorific_prefix
which club does the captain of NER's successor belong to now?	Valerie_Adams	after	club	academic_affiliation
whose ancestor is the father of NER?	Gwangjong_of_Goryeo	issue
which region is the event involved in NER?	Archduchy_of_Austria	event	territory
what does the captain of the successor of NER work for?	Valerie_Adams	after	before
what is the label of the country using NER	Zengovarkony	subdivision_type
what are the awards won by NER's name ship	USS_Daniel_Inouye	ship_namesake	awards
who is the king of NER's election winner	British_general_election,_1727	after_election	monarch
who is the descendant of the person, thing, thing with the same name as NER?	King_George_(1785_ship)	ship_namesake	issue
what is the name of the administrative division of Capital of The birthplace of NER	Reuss_(river)	source1_location	upper_house	party
who is the predecessors of L'avant de Candidate de NER	Wholesale_and_Retail_(constituency)	candidate	before	predecessor
what are the subdivision ratings of the NER ship name	USCGC_Mallow_(WLB-396)	ship_namesake	subdivision_ranks
who is Election's wife after NER	German_presidential_election,_1994	after_election	spouse
which is the capital of the person and things that shares the same name with NER?	HMS_Montserrat_(K586)	ship_namesake	capital
which party belongs to Election after NER	Connecticut_gubernatorial_election,_2006	after_election	title
who commanded the people, things and things with the same name as NER?	USS_Chancellorsville	ship_namesake	commander
which place is called as the subdivision of the northeast of the place that NER takes place?	1972-73_New_York_Knicks_season	place	southeast	subdivision_type
who are the teams participating in the important competitions that NER participates in in a season of the football team?	2010–11_Queens_Park_Rangers_FC_season	s	team
who do the job after the one that is after election of NER	First_Māori_elections	after_election	title
what is the classification level of people, things, and things with the same name as the Dratch-class armored frigate NER?	SMS_Salamander	ship_namesake	platforms
what is the job title of NER's birth country leader?	Gabriel_Urpi	
what is the zoning of the location in the south of the city where the Wikimedia list article NER is located	National_Register_of_Historic_Places_listings_in_Utah_County,_Utah	city	southeast	subdivision_type
NER where is the address of its teams	1986_Paraguayan_Primera_Division_season	team
who are the generals participating in the The name of the NER ship	French_ship_Rivoli_(1810)	ship_namesake	commander
who is the operator of the bay that NER is famous for?	Chesley,_Dawn	
where is the province of the NER Client	Ludvika_Town_Hall	client	subdivision_type
where is the capital of The name of the ship of NER	Maliniec,_Lublin_Voivodeship	subdivision_type
where does the location of the northeastern part of the Catholic bishop NER die belong to which division?	John_James_Joseph_Monaghan	death_place	northeast	subdivision_type
which city does the operator of the stadium that NER takes place belong to?	2011–12_Olympiacos_FC_season	stadium	tenants	city
where is the title of the predecessor of NER located?	Ronald_William_Gainer	before	title	location
which type does the location of the national team that NER belongs to belong to?	Heinrich_Jacob_Goldschmidt	work_institution	affiliations
who is the predecessor of the one that is after election of NER?	Danish_general_election,_2007	after_election	title
NER what the operator of its venue is named for	2013-14_Zamalek_SC_season	stadium	operator	league
what is the subdivisionRanks of The name of the vessel of NER	HMNZS_Moa_(T233)	ship_namesake	subdivision_ranks
who will be people, things and things with the same name as NER next	Cornwallis_(1787_ship)	ship_namesake	honorific_prefix
NER, Wikimedia listing article, what is the positioning of the captain of its club location	2015_FIFA_U-17_World_Cup_squads	club	coach	position
where the area of the Country of NER is participating?	Confederate_Ireland	title_leader
what is the league in which the operator of The stadium where the NER took place will play	2008–09_Everton_FC_season	stadium	southwest	constituency_westminster
what is the flag event established in the country where NER is located Northern Ireland	Belfast_City_Council	party	seats1_title
where is the cradle of the eponymous NER	Siddons_Patera	eponym	birthplace
where is the operator of the venue of NER?	2014–15_Panathinaikos_FC_season	stadium	w	s
where is the alma mater of NER located?	Frank_Darling_(architect)	alma_mater
NER, Wikimedia listing article, what team is the captain of its club location	2006_FIFA_World_Cup_squads	club	coach	currentclub
who does the job after the parent of NER?	Buhe_(politician)	children	title
who do the job after the one that is after election of NER	British_general_election,_1727	after_election	successor
what is the type of creator of NER	Dirt_Sledding	chronology
NER its location, what are the titles of location leaders in the Northwest	2011–12_Liverpool_FC_season	location	title
what is the timezong of the southwest of the south of NER utah, united states?	Manila,_UT	south	southwest	timezone_dst
what is the label of Chronology of NER	The_Milt_Jackson_Big_4	chronology
who is the successor of the people, things and things with the same name as NER?	King_George_(1785_ship)	ship_namesake	issue
what is the occupation of the lyricist of the title of NER?	Hero_(Super_Junior_album)	title	music	education_level
what awards people, things and things with the same name NER won	USS_John_Basilone	ship_namesake	awards
which dynasty did the descendants of NER belong to?	Pyinbya	issue	house
what is the title of The father of NER	Gyeongjong_of_Goryeo	
which division does the person or thing with the same name as NER belong to?	HMCS_Esquimalt_(J272)	ship_namesake	subdivision_type
NER, this is a song sung by Carlos Santana, it is what instrument the creator used	They_All_Went_to_Mexico	chronology	instrument
what is the time zone of the region south of NER Spain	Polynya	s	nw
who is the president of NER's alma mater	Shin_Chang-jae	alma_mater
who is NER's father's spouse	Gwangjong_of_Goryeo	spouse
what is the zoning of the largest city in NER, a federal state in Brazil	Rio_Grande_do_Norte	largest_city
where is the provincial capital of the same name of NER?	USS_Rawlins_(APA-226)	ship_namesake	east
who does the person and things that shares the same name with NER work for?	SMS_Moltke	ship_namesake	allegiance
where does the title of the American statesman NER from Alabama belong to what time zone	George_Wallace_Jr.	title	southwest	southeast
what League NER Timeline Will Play In	The_Way_It's_Goin'_Down	chronology	before
which musical instrument NER timeline used	Parachilna_(album)	chronology
where is the person whose name is used to name NER born?	Martial_(crater)	eponym
which timezone does the city in the south of NER belong to?	Llica_d'Amunt	s	s
who are the teams participating in the important events that NER participates in?	2010–11_Queens_Park_Rangers_FC_season	s	team
what party is the NER's election winner?	Italian_presidential_election,_1978	after_election	honorific_prefix
what is the name of the administrative division of Southern NER County	List_of_National_Historic_Landmarks_in_Massachusetts	county	west
what titles do children of NER have?	Maung_Pu	
where is the birthplace of the one that is after election of NER?	Italian_general_election,_1874	after_election	title
NER, the season of a football team, in which league the operator of its venue plays	2012–13_Ipswich_Town_FC_season	stadium	before	title
what is the party of the inaugural of the title of NER	Tony_Blair	title	inaugural	party
what Happened in the Time of NER's Ship's Name	Bunker_Hill_(1778_ship)	ship_namesake	partof
what language uses Lyrics from The Title of NER	Hero_(Super_Junior_album)	title	music	language
what is the name of the administrative district of Le sud de NER	Prat_de_Comte	s	subdivision_name
what is the nationality of the origin of the NER name?	Donne_(crater)	eponym	nationality
what is the subdivision type of the person and things that shares the same name with NER?	HMCS_New_Westminster	ship_namesake	subdivision_type
what is the position of the person and things that shares the same name with NER?	French_destroyer_Tonkinois	ship_namesake
what Happened in the Time of NER's Ship's Name	SMS_Novara_(1850)	ship_namesake	partof
what is the level of management to the southwest of The stadium where the NER took place	2011–12_Al_Ain_FC_season	stadium	southwest	government_type
in which city is NER's alma mater?	Shin_Chang-jae	alma_mater
what time zone is the location in the southeast of where the NER takes place?	2002-04_European_Nations_Cup_Second_Division	stadium	southeast	timezone_dst
what lies in the south of the event that starts the location of NER	Ratcliffe-on-Soar_power_station	before
where is the city of The operator of The stadium where the NER took place?	2011-12_Greek_Football_Cup	stadium	tenants	ground
With NER what classification class does it have the same name people, things, things belong to	SMS_Seeadler_(1888)	ship_namesake	image_caption
what is the zoning of the location in the northeast of NER?	2008_Vancouver_Whitecaps_FC_season	location	northeast	subdivision_type
NER, WWE's 2012 Night of Champions pay-per-view, who is its sponsor starring	Night_of_Champions_(2012)	sponsor	format
what is the succession of the successor of NER?	Ferdinand_Philippe,_Duke_of_Orleans	issue	succession
who is the leader of NER's successor?	Cambodian_general_election,_2018	leader	after
what the battle of NER's ship's name is	CSS_Stonewall_Jackson	ship_namesake	battles
In a French state (as of March 2015) which district is the main town of NER	Canton_of_Ailly-le-Haut-Clocher	chieftown
where is the location in the southeast of NER and in which region is the location in the southwest?	Levan,_UT	southeast	west	subdivision_name
which type of subdivision does the northeast of the city that NER lives in belong to?	National_Register_of_Historic_Places_listings_in_Weld_County,_Colorado	city	northeast	subdivision_type
NER's election winner who's successor	United_States_Senate_election_in_Vermont,_1980	after_election	successor
Wikimedia lists the location of the article NER what region does the location in the east belong to?	List_of_Phi_Beta_Sigma_chapters	location	east	subdivision_name
what is the genre of the author of NER?	Flanagan's_Shenanigans	chronology	genre
what is the club that the captain of the club that NER belongs to belongs to?	Japan_national_football_team	club	coach	currentclub
who is the predecessors of Election after NER	Taiwan_legislative_election,_1995	after_election	honorific_suffix
where is the title of Election after NER	United_States_Senate_election_in_West_Virginia,_2014	after_election	title
NER what is the division of its home field?	2016-17_Kansas_Jayhawks_women's_basketball_team	home	subdivision_type
who is the leader of the Life of NER region	Rocky_Mountains	region	premier	predecessor
what dynasty does NER's Life of Location belong to?	Sobieski_(train)	locale	legislature	house
NER, the American college basketball season, what is the region of its home west location	2015-16_Utah_State_Aggies_men's_basketball_team	home	west	subdivision_name
which league does the team that won NER belong to?	1986_Paraguayan_Primera_Division_season	team
which league does the operator of NER's venue play for?	2015–16_AEL_Kalloni_FC_season	stadium	tenants	league
who did a job before the one that is after election of NER?	Manila_local_elections,_2016	after_election	predecessor
which type of subdivision does the people, things and things with the same name as NER belong to?	USCGC_Grand_Isle_(WPB-1338)	ship_namesake	subdivision_type
who is the leader of the East of The stadium where the NER took place	2011_Chinese_FA_Cup	stadium	northwest	leader_name
which timezone does the city in the south of NER belong to?	Bigues_i_Riells	s	subdivision_type
what is the famous work of the person named NER?	Conon_(crater)	eponym
who commanded the name included in the NER?	Germanic_Wars	name
which place is called as the subdivision of the southwest of the home to NER?	2011-12_Utah_State_Aggies_men's_basketball_team	home	southwest	subdivision_name
what is the person whose name is used to name NER known for?	Kamerlingh_Onnes_(crater)	eponym	workplaces
who is the predecessor of the one that is after election of NER?	United_States_Senate_election_in_New_York,_1964	after_election	title
what is the national team captain of your next NER club	Valerie_Adams	after	before	before
where is the city of The operator of The stadium where the NER took place	2014–15_AEL_Kalloni_FC_season	stadium	location
what is the subdivision type of the city in the south of NER spain?	Bigues_i_Riells	s	subdivision_type
what is the management level of NER ship name brought to us for analysis; now museum?	German_corvette_Hiddensee	ship_namesake
what offspring did the mother of the consort of King NER of Egypt have?	Ptolemy_X_Alexander_I	spouse	issue
who is the predecessors of Election after NER	German_federal_election,_1920	after_election	before
What's the deal with NER's sponsors?	Coca-Cola_Topnotchers	sponsor	type
who is the incumbent of the title of the candidate of NER?	Constitution_election_results_in_the_United_Kingdom_general_election,_1922	candidate	title	incumbent
who are the current holders of the Head of Publication Event of NER	Sulaiman_(Brunei)	religion
which religion does the person and things that shares the same name with NER belong to?	President_El_Hadj_Omar_Bongo_(ship,_1978)	ship_namesake	predecessor
what is the award for the election winner of Minnesota's Election NER?	United_States_presidential_election_in_Minnesota,_1968	after_election	awards
what is the national team of the captain of the NER club location?	2014_FIFA_World_Cup_squads	club	coach	currentclub
who leads the event happened in NER?	Germania_Superior	era
what is the religion of the administrative area that NER is responsible for?	Doge_of_Genoa	
what is the club that the captain of the club that NER belongs to belongs to?	2015_UEFA_European_Under-19_Championship_squads	club	coach	clubs
who is the predecessor of the person and things that shares the same name with NER?	USCGC_Duane	ship_namesake	after
what time zone is the location south of NER in?	Llica_d'Amunt	s	s
what is the title of the person and things that shares the same name with NER	Italian_ironclad_Enrico_Dandolo	ship_namesake	title
what type of creators are NER	Etta_James_(1973_album)	chronology
NER's election winner who's successor	United_Malaysia_National_Organization_leadership_election,_1972	after_election	honorific_suffix
what is the country of NER's alma mater?	Bob_Padilla	alma_mater
where is the alma mater of Name of the leader of The label of NER	Hong_Kong_legislative_election,_2016_(New_Territories_West)	label	leader1_name	alma_mater
which studio does the car that NER is related to belong to?	Shark_(2013_TV_series)	related
which region does the event of NER belong to?	Tanukhids	event	place
what is the religion of the person or thing with the same name as NER?	SAS_President_Kruger_(F150)	ship_namesake	religion
who is the predecessors of Election after NER	Finnish_presidential_election,_1994	after_election	after
what time zone uses Northern NER location	Colorado_State_Rams_football	location	north	timezone_dst
what is the language of the lyricist of the title of NER	The_Beat_Goes_On_(Super_Junior_D&E_album)	title	lyrics	language
where is the death place of NER's ship name	USS_Susan_B_Anthony_(AP-72)	ship_namesake
what is the profession of Your next club Editor of NER	The_Collector's_Series,_Volume_One	extra	title
who is the successor of the leader of NER?	Spanish_general_election,_1869	leader	after
who is the writing team behind NER Timeline dj quik, lord tariq and peter gunz?	The_Way_It's_Goin'_Down	chronology	team
With which countries the people, things and things with the same name in NER participated in the war	Waterloo_(1815_ship)	ship_namesake	combatant
which type of government does NER related events belong to?	Kingdom_of_Galicia_and_Lodomeria	event	government_type
in which region the person whose name is used to name the NER is	Penticton_(crater)	eponym	subdivision_name
which province is the southeast of the stadium that NER takes place settled in?	1952–53_European_Rugby_League_Championship	stadium	southeast	settlement_type
which region does the division that NER belongs to belong to?	Toluca_Cathedral	division	metro_archbishop
NER to which time zone does the southern region belong	Masdenverge	s	s
who the current holders of the NER Candidate title are	Constitution_election_results_in_the_United_Kingdom_general_election,_1929	candidate	title	incumbent
which party does the one that is after election of NER belong to?	List_of_heads_of_state_of_Hungary	residence	established_event
where is the birthplace of the city of Captain from NER's club	2014_FIFA_World_Cup_squads	club	coach	currentclub
which club does the captain of the club that NER belongs to belong to?	2015_FIFA_U-20_World_Cup_squads	club	coach	clubs
what is the subdivision name of the southwest of the city that NER lives in?	National_Register_of_Historic_Places_listings_in_Horry_County,_South_Carolina	city	southwest	subdivision_name
who is the successor of the one that is after election of NER?	Spanish_general_election,_1931	after_election	title
which division does the person or thing with the same name as NER belong to?	HMCS_New_Westminster	ship_namesake	subdivision_type
who is the mother of the previous generation of the descendants of NER?	Wilhelmina_of_Prussia,_Princess_of_Orange	issue	before	mother
what products do NER's sponsors have	Black_Opal_Stakes	sponsor	products
what is the job of the successor of the writer of NER?	My_Love:_Essential_Collection	extra	occupation
what is the predecessor of the person or thing with the same name as NER?	French_cruiser_Georges_Leygues	ship_namesake	before
who is the heir of Election after NER	Romanian_general_election,_1922	after_election	predecessor
which place is called as the subdivision of NER's southern region?	Polynya	s	w
who is the leader of the legislature of the region of NER?	Keokuk_Limestone	region	legislature	leader
what is the status of the area where NER is used	Lautoka	
what is the classification level of a person or thing with the same name as NER	USS_Toucan_(AM-387)	ship_namesake	subdivision_ranks
what is the league in which the operator of The stadium where the NER took place will play?	2011–12_Olympiacos_FC_season	stadium	before	tenants
which type of subdivision does the northwest of the stadium that NER takes place belong to?	2015_Copa_do_Brasil_First_Round	stadium	northwest	subdivision_type
who do the job after the one that is after election of NER	United_States_Senate_election_in_Colorado,_2004	after_election	successor
which region does the event involved in NER belong to?	Archduchy_of_Austria	event	territory
which timezone does the south of the city that NER lives in belong to?	National_Register_of_Historic_Places_listings_in_Salt_Lake_County,_Utah	city	south	timezone_dst
Jolin Tsai's 2006 song NER song, what is the occupation of the singer	Dancing_Forever	extra	profession
NER, Tommy Flanagan's album, what is the occupation of its creator	Flanagan's_Shenanigans	chronology	occupation
which division does the location in the southwest of NER's city belong to?	CBTK-FM	city	southwest	subdivision_type
who is the successor of the spouse of the descendant of NER	Sigebert_III	issue	spouse	successor
what time zone is the location south of NER in?	Siurana,_Alt_Emporda	s	timezone1_dst
what is the subdivision rank of the people, things and things with the same name as NER?	HMNZS_Moa_(T233)	ship_namesake	subdivision_ranks
where is the title of Election after NER	Philippine_presidential_election,_1953	after_election	title
what is the subject of the one that is influenced by NER	Rozdzielna	subdivision_type
NER, Wikimedia listing article, what team is the captain of its club location	2015_FIFA_U-17_World_Cup_squads	club	coach	clubs
what is the previous generation of the operator of NER's successor	Hard_Rock_Stadium	after	before
where does the title of NER's predecessor belong?	Lai_Tung-kwok	predecessor	title	incumbent
what is the administrative district of Principal city of NER	Canton_of_Remiremont	chieftown
who are the descendants of Le chef de NER	Duchy_of_Anhalt	leader	issue
where did the origin of NER's name study?	Boltzmann_(crater)	eponym	alma_mater
What's wrong with The Winner of NER, A Battle Fought in China in 617?	Battle_of_Huoyi	result	succession
what is the time zone of NER ship name	French_ship_Polyphemus_(1815)	ship_namesake	subdivision_type
which rank does the people, things and things with the same name as NER belong to?	USS_Swallow_(AM-65)	ship_namesake
which country does the one that is after election of NER belong to?	United_States_presidential_election_in_Wisconsin,_1880	after_election
what eponymous domain of NER belongs to	Stokes_(Martian_crater)	eponym	title
who is the successor of NER's namesake?	French_cruiser_Georges_Leygues	ship_namesake	successor
do You Know what Language Lyrics Of NER's Title Is Using	The_Beat_Goes_On_(Super_Junior_D&E_album)	music
which rank does the person and things that shares the same name with NER belong to?	USS_Rattlesnake_(1813)	ship_namesake	subdivision_ranks
who leads the person and things that shares the same name with NER	HMS_St_Helena_(K590)	ship_namesake	established_event
what is the title of the location leader in the south of the location of NER?	2002_Lamar_Hunt_US_Open_Cup	location	north	timezone_dst
what language the singer who played for NER uses	Boysitter	extra
who managed the operator of the stadium that NER takes place?	2014_CAF_Champions_League_qualifying_rounds	stadium	tenants	stadium
which branch does the person and things that shares the same name with NER belong to?	USS_General_Greene_(1799)	ship_namesake	spouse
where the Northeast of NER site is	2015-16_Houston_Cougars_women's_basketball_team	home	northwest	subdivision_name
who is the predecessor of NER's election winner?	Thai_general_election,_1996	after_election	successor
where did the people, things and things with the same name as NER study?	MS_Thorbjorn	ship_namesake	alma_mater
The title of Explanation of NER who are the current holders	Taiwanese_municipal_elections,_2010	caption	premier
what is the area covered by the Division of NER Mexico, named after Saint Joseph?	Toluca_Cathedral	division	metro_archbishop	diocese
what is the language that is commonly used by the cause of NER?	Kalmar_Union	
where is the address of The operator of The stadium where the NER took place	2016–17_Panathinaikos_FC_season	stadium	n	n
what is the type of the people, things and things with the same name as NER?	RV_Neil_Armstrong_(AGOR-27)	ship_namesake	type
what is the religion of the father of NER?	Mihrisah_Sultan	issue	title
who is the predecessor of the commander of NER?	Canton_of_Aiguilles	chieftown
what are the affiliates of Alma mater of NER	Art_Peck	alma_mater
what is the title of The Father of NER	Emperor_Xiaowu_of_Northern_Wei	
who is the predecessor of the inaugural of the title of NER?/ who is the father of the inaugural of the title of NER?	Tony_Blair	title	inaugural	before
which place is called as the subdivision of the west of the city that NER utah, united states, lives in?	Lake_Mountains	city	west	subdivision_name
which stadium hosts the NER Divisions	2009-10_in_Australian_soccer	division
what is the region of the same name of NER?	HMCS_Kamloops	ship_namesake	subdivision_name
where is NER's eponymous Alma Mater	Cavendish_(crater)	eponym	alma_mater
which province does the alma mater of NER belong to?	Frank_Darling_(architect)	alma_mater
what is the The life of The stadium where the NER took place	2013-14_Zamalek_SC_season	stadium	legislature	legislature
which religion does the parent of NER believe?	Didit_Hediprasetyo	parents
NER's election winner who's successor	French_legislative_election,_1914	after_election	title
which club does the captain of the NER club location now belong to?	UEFA_Euro_2012_squads	club	coach	currentclub
who did a job before the one that is after election of NER?	Manila_local_elections,_2016	after_election	predecessor
what is the club that the captain of the club that NER belongs to belongs to?	2006_FIFA_World_Cup_squads	club	coach	currentclub
what is the office of the one that is after election of NER?	National_Liberation_Party_presidential_primary,_2009	after_election	office
what type of NER Timeline	Girls_Just_Wanna_Have_Fun_(Shaggy_song)	chronology
what is the occupation of the creator of NER	Unbreakable_(Janet_Jackson_album)	chronology	profession
what is the zoning of the southern region of NER Spain	Gisclareny	s	e
where is the provincial capital of a person or thing with the same name as NER	USS_Cayuga_County_(LST-529)	ship_namesake	seat
NER where are its main towns located	Canton_of_Ribemont	chieftown
who is the predecessor of the leader of NER?	Albanian_Kingdom_(1928–39)	leader	issue
what is the city of the operator of the NER venue?	2013-14_Barnet_FC_season	stadium	southeast
who is the last person to run the NER position for the American college football team?	2014_BYU_Cougars_football_team	location	before
what is the management level of NER south	Vilallonga_de_Ter	s	subdivision_type
who is influenced by the person whose name is used to name NER?	Mach_(crater)	eponym	workplaces
which label does the location country of NER have?	HK_MK_Bled	league
where is the address of the operator of the stadium where the NER football team season took place?	2016-17_PAOK_FC_season	stadium	location
which team does the captain of the club that NER belongs to belong to?	2016_UEFA_European_Under-17_Championship_squads	club	coach	clubs
what is the national team of Captain of The club of NER	UEFA_Euro_2012_squads	club	coach	currentclub
what are the things related to NER related things	sony_xperia_z3+	related	related
what is NER's title of the same name	Spanish_cruiser_Don_Antonio_de_Ulloa	ship_namesake
what are the subdivision ratings of the NER ship name	HMS_Mongoose_(1799)	ship_namesake
NER, Wikimedia listing article, what team is the captain of its club location	2010_FIFA_World_Cup_squads	club	coach	currentclub
what is the name of the administrative division of Northeastern Northwestern NER	Koosharem,_UT	northwest	south	subdivision_name
who is the predecessor of NER's election winner?	First_Māori_elections	after_election	honorific_prefix
NER, Wikimedia listing article, to which club the captain of its club location now belongs	2004_African_Cup_of_Nations_squads	club	captain	clubs
what the program format of NER's L'avant de Paroles is?	Prudence_Liew_(album)	lyrics	before	format
what is the nationality of the head of NER	Government_of_National_Salvation	leader	nationality
what is the office of the candidate of the predecessor of NER?	Prince_(constituency)	previous	region	district
what is the currency of the event that starts the location of NER?	2010-11_in_Spanish_Football	location	currency_unit
what dynasty did NER's father belong to?	Princess_Pingyang_(Han_dynasty)	father	house
NER, a Chinese politician (1886-1975) who was the chairman he played	Dong_Biwu	premier	predecessor
what does a lyricist with the title of NER do?	Ride_Me_(album)	title	genre
which type of government does the event that starts the location of NER belong to?	Honduras_national_football_team_results_(1990–99)	location	established_event	government_type
who is the leader of the Northeast of The stadium where the NER took place	2013_AFC_Champions_League_group_stage	stadium	before	before
what is the location of the west of the location of NER?	2000-01_Ipswich_Town_FC_season	location	west	constituency_westminster
who is the predecessor of Election after NER	National_Justice_Party_leadership_election,_2001	after_election	honorific_prefix
who is next to the The father of NER	Liu_Zhiyuan	after
where is the place where the person whose name was used to name the NER died	Galvani_(crater)	eponym	death_place
what is the name of the predecessor of the club that NER belongs to?	Football_at_the_2014_Asian_Games_-_Squads	club	before	name
what is the legislature for the position of NER's national team?	Kuwana_Domain	
what was the name of the institution before the participating countries of the war NER?	Confederate_Ireland	title_leader
where is the city of The operator of The stadium where the NER took place	2016-17_PAOK_FC_season	stadium	location
what is the name of the administrative district of Northwest of NER	Mieres,_Girona	nw	w	subdivision_name
what is the office of the leader of NER?	London_local_elections,_2018	leader	title
what time zone uses NER's Southern Site	2013-14_UC_Davis_Aggies_men's_basketball_team	home	north	timezone_dst
what is the subdivision name of the southeast of the stadium that NER takes place?	2014–15_FC_Petrolul_Ploiesti_season	stadium	southeast	subdivision_name
what Musical Instrument NER Timeline Did He Use	Acoustic_Hearts_of_Winter	chronology
